нкп=-Некорректно. 
нквыбор=-Некорректно. Выберите что-то одно
нкслужебка=-Некорректно. Запрещена продажа служебного транспорта
нкмакс=-Некорректно. Максимальная цена не более 1млрд.$
нкд=-Некорректно. Минимальная цена продажи дома: 10.000$
нкгоска=-Некорректно. Минимальная цена продажи этого транспорта $
нкнаркота=-Некорректно. Наркотики не распростроняем
нккласс=-Некорректно. Не существует домов выше 7-го класса
нксимка=-Некорректно. Номера телефонов только 2-7 значные
нкдон=-Некорректно. Покупка/продажа не редактируется
нкмарка=-Некорректно. Такой марки не существует
нкма=-Некорректно. Укажите марку автомобиля
нкмв=-Некорректно. Укажите марку велосипеда
нкмм=-Некорректно. Укажите марку мотоцикла
нк=-Некорректно.
млн=[курсор]млн
тыс=[курсор]тыс
хфл=[Full]
хфс=[Full]
хфул=[Full]
хпл=[Plus]
тюнинг=Автомастерская
комф=Автосалон Комфорт
эко=Автосалон Эконом
элит=Автосалон Элитный
азс=АЗС
заправка=АЗС
гентон=в "Опасном районе"
гетто=в "Опасном районе"
грув=в "Опасном районе"
ор=в "Опасном районе"
увмф=в военном городке
глв=в г. Лас-Вентурас
указика=в г. Лас-Вентурас
указино=в г. Лас-Вентурас
глс=в г. Лос-Сантос
гсф=в г. Сан-Фиерро
вдоме=в доме №
джизи=в клубе "Jizzy"
прилв=в пригороде Лас-Вентураса
прлв=в пригороде Лас-Вентураса
прилс=в пригороде Лос-Сантоса
прлс=в пригороде Лос-Сантоса
улеса=в пригороде Лос-Сантоса
уфермы=в пригороде Лос-Сантоса
присф=в пригороде Сан-Фиерро
прсф=в пригороде Сан-Фиерро
ушахты=в пригороде Сан-Фиерро
уввс=в пустыне
усв=в пустыне
пкр=в районе "Palomino Creek"
ркрик=в районе "Palomino Creek"
пп=в районе "Prickle Pine"
прикл=в районе "Prickle Pine"
рублевка=в районе "Prickle Pine"
врс=Воздушные RC игрушки
игрушки=Воздушные RC игрушки
продукты=Закусочная
столовая=Закусочная
.ичел=ичел[курсор]=Ищу человека по имени
.ишу=ишу[курсор]=Ищу человека по имени
.Ишу=Ишу[курсор]=Ищу человека по имени
.ищу=ищу[курсор]=Ищу человека по имени
.Ищу=Ищу[курсор]=Ищу человека по имени
24/7=Магазин 24/7
247=Магазин 24/7
хиппи=Магазин Hippi
вайнвуд=на горе "VineWood"
вв=на горе "VineWood"
пляж=на пляже "Санта-Мария"
сантамария=на пляже "Санта-Мария"
см=на пляже "Санта-Мария"
прыжки=Парашютные прыжки
парик=Парикмахерская
петарды=Пиротехника
салюты=Пиротехника
агенство=Риэлторское агенство
рыбацкий=Рыболовный магазин
акура=Acura
адмирал=Admiral
ак-47=AK-47
ака=AK-47
калаш=AK-47
альфа=Alpha
астон=Aston Martin DB11
аудик=Audi Q8R
аудир=Audi R8
багаж=Baggage
бандито=Bandito
банши=Banshee
барак=Barracks
бфа=BF Injection
бф-400=BF-400
бф400=BF-400
бфм=BF-400
байк=Bike
блейд=Blade
блиста=Blista compact
компакт=Blista Compact
блудринг=Bloodring Banger
бмв2=BMW M2 F87
бмв3=BMW M3 E46
бмвр=BMW R 1200RT
бмх=BMX
боб=Bobcat
бравура=Bravura
броад=Broadway
броадвей=Broadway
брод=Broadway
бродвей=Broadway
буканир=Buccaneer
буфало=Buffalo
балет=Bullet
булка=Bullet
бур=Burrito
кеди=Caddy
кадил=Cadillac XT6
кадрона=Cadrona
кемпер=Camper
читах=Cheetah
камаро=Chevrolet Camaro
каприз=Chevrolet Caprice
корвет=Chevrolet Corvette C6
импала=Chevrolet Impala 2018
тахое=Chevrolet Tahoe
чопер=Chopper
кловер=Clover
клаб=Club
клуб=Club
коач=Coach
комет=Comet
винта=Country rifle
винтовка=Country rifle
рифл=Country rifle
рифла=Country rifle
дигл=Desert Eagle
чарджрт=Dodge Charger R/T
чардж=Dodge Charger
дозер=Dozer
дампер=Dumper
дюна=Duneride
дюнерайд=Duneride
глайд=Electra Glide
елегант=Elegant
еледжи=Elegy
имперор=Emperor
енфор=Enforcer
есперанто=Esperanto
евро=Euros
фаджио=Faggio
фбир=FBI Rancher
фбит=FBI Truck
фкр=FCR-900
фкр-900=FCR-900
фкр900=FCR-900
фцр=FCR-900
фцр-900=FCR-900
фцр900=FCR-900
фельтзер=Feltzer
фер=Ferrari 488 GTB
файр=Firetruck
флеш=Flash
виктория=Ford Crown Victoria
експл=Ford Explorer
мустанг=Ford Shelby Mustang
таурус=Ford Taurus
фортун=Fortune
фривей=Freeway
фл=Full
фс=Full
фул=Full
глендалш=Glendale Shit
глендал=Glendale
гринвуд=Greenwood
гермес=Hermes
сивик=Honda Civic Gen 3
корнет=Honda Cornet C8600F
дио=Honda Dio
хорнет=Honda Hornet C8600F
хспорт=Honda Sportrax 250EX
хондахре=Honda XRE-300
иксре=Honda XRE300
хоткнайф=Hotknife
хотнайф=Hotknife
хота=Hotring Racer A
хотб=Hotring Racer B
хот=Hotring Racer
хпв=HPV-1000
хам=Hummer H2
хантли=Huntley
хастлер=Hustler
инф=Infernus
инфин=Infinity FX35
интрудер=Intruder
чироки=Jeep Cherokee SRT WK1
джестер=Jester
джурни=Journey
карт=Kart
каван=Kawasaki NRR 1000
каваз=Kawasaki Z400FX
2107=Lada 2107
приора=Lada Priora
ламб=Lamborghini Gallardo
ландсталкер=Landstalker
сталкер=Landstalker
лекс300=Lexus IS300
лекс5=Lexus LS500
лайнер=Linerunner
ияк=Академия боевых искусств "Aikido" приглашает всех желающих
аамц=Арендую а/м "[курсор]" за $
аамхц=Арендую а/м "[курсор]"[] за $
аамх=Арендую а/м "[курсор]"[]
аам=Арендую а/м "[курсор]"
аац=Арендую автомобиль любой марки за $
аахц=Арендую автомобиль любой марки[[курсор]] за $
аах=Арендую автомобиль любой марки[[курсор]]
аа=Арендую автомобиль любой марки
ад1ц=Арендую дом 1-го класса за $
ад1=Арендую дом 1-го класса
ад2ц=Арендую дом 2-го класса за $
ад2=Арендую дом 2-го класса
ад3ц=Арендую дом 3-го класса за $
ад3=Арендую дом 3-го класса
ад4ц=Арендую дом 4-го класса за $
ад4=Арендую дом 4-го класса
ад5ц=Арендую дом 5-го класса за $
ад5=Арендую дом 5-го класса
ад6ц=Арендую дом 6-го класса за $
ад6=Арендую дом 6-го класса
ад=Арендую дом
алц=Арендую любое транспортное средство за $
алхц=Арендую любое транспортное средство[[курсор]] за $
алх=Арендую любое транспортное средство[[курсор]]
ал=Арендую любое транспортное средство
аммц=Арендую м/м "[курсор]" за $
аммхц=Арендую м/м "[курсор]"[] за $
аммх=Арендую м/м "[курсор]"[]
амм=Арендую м/м "[курсор]"
амц=Арендую мотоцикл любой марки за $
амхц=Арендую мотоцикл любой марки[[курсор]] за $
амх=Арендую мотоцикл любой марки[[курсор]]
ам=Арендую мотоцикл любой марки
ад7ц=Арендую особняк 7-го класса за $
ад7=Арендую особняк 7-го класса
мпвм=В ЧЧ:ММ состоится мероприятие "[курсор]". Место сбора: 
кжинтимц=Воспользуюсь интимными услугами за $
кинтимц=Воспользуюсь интимными услугами за $
кминтимц=Воспользуюсь интимными услугами за $
кжинтим=Воспользуюсь интимными услугами
кинтим=Воспользуюсь интимными услугами
кминтим=Воспользуюсь интимными услугами
кскидавто=Воспользуюсь скидочным купоном в автосалоне
вскид=Воспользуюсь скидочным купоном в магазине 24/7
кскидмаг=Воспользуюсь скидочным купоном в магазине 24/7
кскидакс=Воспользуюсь скидочным купоном в магазине аксессуаров
кскидод=Воспользуюсь скидочным купоном в магазине одежды
кскидмото=Воспользуюсь скидочным купоном в мотосалоне
кавтомехц=Воспользуюсь услугами автомеханика за $
кмехц=Воспользуюсь услугами автомеханика за $
кавтомех=Воспользуюсь услугами автомеханика
кмех=Воспользуюсь услугами автомеханика
кадвоклв=Воспользуюсь услугами адвоката в г. Лас-Вентурас
кадвоклс=Воспользуюсь услугами адвоката в г. Лос-Сантос
кадвоксф=Воспользуюсь услугами адвоката в г. Сан-Фиерро
кадвок=Воспользуюсь услугами адвоката
квтаксиц=Воспользуюсь услугами воздушного такси за $
квтакси=Воспользуюсь услугами воздушного такси
кгрузц=Воспользуюсь услугами грузоперевозчика за $
кгруз=Воспользуюсь услугами грузоперевозчика
кжнчц=Воспользуюсь услугами домработницы за $
кжнч=Воспользуюсь услугами домработницы
кцветыц=Воспользуюсь услугами доставщика цветов за $
кцветы=Воспользуюсь услугами доставщика цветов
клицлв=Воспользуюсь услугами лицензера в г. Лас-Вентурас
клицлс=Воспользуюсь услугами лицензера в г. Лос-Сантос
клицсф=Воспользуюсь услугами лицензера в г. Сан-Фиерро
клиц=Воспользуюсь услугами лицензера
кличныйводительц=Воспользуюсь услугами личного водителя за $
кличныйводитель=Воспользуюсь услугами личного водителя
ккрупье=Воспользуюсь услугами личного крупье
кличныйохранникц=Воспользуюсь услугами личного охранника за $
кличныйохранник=Воспользуюсь услугами личного охранника
кдоклв=Воспользуюсь услугами медицинского центра г. Лас-Вентурас
кдоклс=Воспользуюсь услугами медицинского центра г. Лос-Сантос
кдоксф=Воспользуюсь услугами медицинского центра г. Сан-Фиерро
кдок=Воспользуюсь услугами медицинского центра
кмнчц=Воспользуюсь услугами мужа на час за $
кмнч=Воспользуюсь услугами мужа на час
кедац=Воспользуюсь услугами развозчика еды за $
кразвозчикц=Воспользуюсь услугами развозчика еды за $
кеда=Воспользуюсь услугами развозчика еды
кразвозчик=Воспользуюсь услугами развозчика еды
ктаксиц=Воспользуюсь услугами такси за $
ктакц=Воспользуюсь услугами такси за $
ктак=Воспользуюсь услугами такси
ктакси=Воспользуюсь услугами такси
кмани=Воспользуюсь финансовыми услугами в размере $
вяк=Вступлю в академию боевых искусств "Aikido" учеником
вацтек=Вступлю в баскетбольную команду "Aztecas"
вбалл=Вступлю в баскетбольную команду "Ballas"
вгрув=Вступлю в баскетбольную команду "Grove"
врифа=Вступлю в баскетбольную команду "Rifa"
ввагос=Вступлю в баскетбольную команду "Vagos"
исем=Ищу дальних родственников. О себе: 
идевсекс=Ищу девушку для интимных отношений. О себе: 
идев=Ищу девушку. О себе: 
идринт=Ищу друга по интересам. Интересует: 
идр=Ищу друга. О себе: 
ищудруга=Ищу друга. О себе: 
идруз=Ищу друзей. О себе: 
ипарсекс=Ищу парня для интимных отношений. О себе: 
ипар=Ищу парня. О себе: 
ибиз=Ищу партнера по бизнесу. О себе: 
ищубиз=Ищу партнера по бизнесу. О себе: 
иподр=Ищу подругу. О себе: 
ищуподругу=Ищу подругу. О себе: 
игонкас=Ищу соперника для гоночных заездов на $
игонкац=Ищу соперника для гоночных заездов на $
игонкаас=Ищу соперника для гоночных заездов на автомобиле "[курсор]" на $
игонкаац=Ищу соперника для гоночных заездов на автомобиле "[курсор]" на $
игонкаа=Ищу соперника для гоночных заездов на автомобиле "[курсор]"
игонкавс=Ищу соперника для гоночных заездов на велосипеде "[курсор]" на $
игонкавц=Ищу соперника для гоночных заездов на велосипеде "[курсор]" на $
игонкав=Ищу соперника для гоночных заездов на велосипеде "[курсор]"
игонкакс=Ищу соперника для гоночных заездов на квадроцикле "Quad" на $
игонкакц=Ищу соперника для гоночных заездов на квадроцикле "Quad" на $
игонкак=Ищу соперника для гоночных заездов на квадроцикле "Quad"
игонкамс=Ищу соперника для гоночных заездов на мотоцикле "[курсор]" на $
игонкамц=Ищу соперника для гоночных заездов на мотоцикле "[курсор]" на $
игонкам=Ищу соперника для гоночных заездов на мотоцикле "[курсор]"
игонка=Ищу соперника для гоночных заездов
икости=Ищу соперника для совместной азартной игры "Кости"
иазарт=Ищу соперника для совместной азартной игры
и21=Ищу соперника для совместной карточной игры "Блэкджек"
идур=Ищу соперника для совместной карточной игры "Дурак"
ипокер=Ищу соперника для совместной карточной игры "Покер"
имбц=Ищу соперника для совместной мобильной игры "Морской бой" на $
имб=Ищу соперника для совместной мобильной игры "Морской бой"
итет=Ищу соперника для совместной мобильной игры "Тетрис"
ишахц=Ищу соперника для совместной мобильной игры "Шахматы" на $
ишах=Ищу соперника для совместной мобильной игры "Шахматы"
ишашц=Ищу соперника для совместной мобильной игры "Шашки" на $
ишаш=Ищу соперника для совместной мобильной игры "Шашки"
ихекц=Ищу соперника для совместной мобильной игры "Hexxagon" на $
ихек=Ищу соперника для совместной мобильной игры "Hexxagon"
иигра=Ищу соперника для совместной мобильной игры
исосед=Ищу соседа по дому. О себе: 
заллв=Ищу спарринг-партнёра в спортзал г. Лас-Вентурас
заллс=Ищу спарринг-партнёра в спортзал г. Лос-Сантос
залсф=Ищу спарринг-партнёра в спортзал г. Сан-Фиерро
ичел=Ищу человека по имени 
иник=Ищу человека по псевдониму 
пкомпания=Компания "[курсор]"
ккгдрц=Куплю [курсор] кг дерева за $
кхдрц=Куплю [курсор] кг дерева за $
ккгдр=Куплю [курсор] кг дерева
кхдр=Куплю [курсор] кг дерева
ккгжц=Куплю [курсор] кг железа за $
кхжц=Куплю [курсор] кг железа за $
ккгж=Куплю [курсор] кг железа
кхж=Куплю [курсор] кг железа
ккгдржц=Куплю [курсор] кг строительных материалов за $
ккгждрц=Куплю [курсор] кг строительных материалов за $
кхстрц=Куплю [курсор] кг строительных материалов за $
ккгдрж=Куплю [курсор] кг строительных материалов
ккгждр=Куплю [курсор] кг строительных материалов
кхстр=Куплю [курсор] кг строительных материалов
кхрепц=Куплю [курсор] положительных отзывов за $
кхреп=Куплю [курсор] положительных отзывов
к1репц=Куплю [курсор]1 положительный отзыв за $
к1реп=Куплю [курсор]1 положительный отзыв
к2репц=Куплю [курсор]2 положительных отзыва за $
к2реп=Куплю [курсор]2 положительных отзыва
к3репц=Куплю [курсор]3 положительных отзыва за $
к3реп=Куплю [курсор]3 положительных отзыва
к4репц=Куплю [курсор]4 положительных отзыва за $
к4реп=Куплю [курсор]4 положительных отзыва
камц=Куплю а/м "[курсор]" за $
камхц=Куплю а/м "[курсор]"[] за $
камх=Куплю а/м "[курсор]"[]
кам=Куплю а/м "[курсор]"
какурац=Куплю а/м "Acura" за $
какурахц=Куплю а/м "Acura"[[курсор]] за $
какурах=Куплю а/м "Acura"[[курсор]]
какура=Куплю а/м "Acura"
кадмц=Куплю а/м "Admiral" за $
кадмхц=Куплю а/м "Admiral"[[курсор]] за $
кадмх=Куплю а/м "Admiral"[[курсор]]
кадм=Куплю а/м "Admiral"
кальц=Куплю а/м "Alpha" за $
кальхц=Куплю а/м "Alpha"[[курсор]] за $
кальх=Куплю а/м "Alpha"[[курсор]]
каль=Куплю а/м "Alpha"
кастонц=Куплю а/м "Aston Martin DB11" за $
кастонхц=Куплю а/м "Aston Martin DB11"[[курсор]] за $
кастонх=Куплю а/м "Aston Martin DB11"[[курсор]]
кастон=Куплю а/м "Aston Martin DB11"
каудикц=Куплю а/м "Audi Q8R" за $
каудикхц=Куплю а/м "Audi Q8R"[[курсор]] за $
каудикх=Куплю а/м "Audi Q8R"[[курсор]]
каудик=Куплю а/м "Audi Q8R"
каудирц=Куплю а/м "Audi R8" за $
каудирхц=Куплю а/м "Audi R8"[[курсор]] за $
каудирх=Куплю а/м "Audi R8"[[курсор]]
каудир=Куплю а/м "Audi R8"
кбагц=Куплю а/м "Baggage" за $
кбагхц=Куплю а/м "Baggage"[[курсор]] за $
кбагх=Куплю а/м "Baggage"[[курсор]]
кбаг=Куплю а/м "Baggage"
кбандц=Куплю а/м "Bandito" за $
кбандхц=Куплю а/м "Bandito"[[курсор]] за $
кбандх=Куплю а/м "Bandito"[[курсор]]
кбанд=Куплю а/м "Bandito"
кбаншц=Куплю а/м "Banshee" за $
кбаншхц=Куплю а/м "Banshee"[[курсор]] за $
кбаншх=Куплю а/м "Banshee"[[курсор]]
кбанш=Куплю а/м "Banshee"
кбаракц=Куплю а/м "Barracks" за $
кбаракхц=Куплю а/м "Barracks"[[курсор]] за $
кбаракх=Куплю а/м "Barracks"[[курсор]]
кбарак=Куплю а/м "Barracks"
кбфиц=Куплю а/м "BF Injection" за $
кбфихц=Куплю а/м "BF Injection"[[курсор]] за $
кбфих=Куплю а/м "BF Injection"[[курсор]]
кбфи=Куплю а/м "BF Injection"
кблец=Куплю а/м "Blade" за $
кблехц=Куплю а/м "Blade"[[курсор]] за $
кблех=Куплю а/м "Blade"[[курсор]]
кбле=Куплю а/м "Blade"
кблиц=Куплю а/м "Blista Сompact" за $
кблихц=Куплю а/м "Blista Сompact"[[курсор]] за $
кблих=Куплю а/м "Blista Сompact"[[курсор]]
кбли=Куплю а/м "Blista Compact"
кблац=Куплю а/м "Bloodring Banger" за $
кблуц=Куплю а/м "Bloodring Banger" за $
кблахц=Куплю а/м "Bloodring Banger"[[курсор]] за $
кблухц=Куплю а/м "Bloodring Banger"[[курсор]] за $
кблах=Куплю а/м "Bloodring Banger"[[курсор]]
кблух=Куплю а/м "Bloodring Banger"[[курсор]]
кбла=Куплю а/м "Bloodring Banger"
кблу=Куплю а/м "Bloodring Banger"
кбмв2ц=Куплю а/м "BMW M2 F87" за $
кбмв2хц=Куплю а/м "BMW M2 F87"[[курсор]] за $
кбмв2х=Куплю а/м "BMW M2 F87"[[курсор]]
кбмв2=Куплю а/м "BMW M2 F87"
кбмв3ц=Куплю а/м "BMW M3 E46" за $
кбмв3хц=Куплю а/м "BMW M3 E46"[[курсор]] за $
кбмв3х=Куплю а/м "BMW M3 E46"[[курсор]]
кбмв3=Куплю а/м "BMW M3 E46"
кбрац=Куплю а/м "Bravura" за $
кбрахц=Куплю а/м "Bravura"[[курсор]] за $
кбрах=Куплю а/м "Bravura"[[курсор]]
кбра=Куплю а/м "Bravura"
кброц=Куплю а/м "Broadway" за $
кброхц=Куплю а/м "Broadway"[[курсор]] за $
кброх=Куплю а/м "Broadway"[[курсор]]
кбро=Куплю а/м "Broadway"
кбукц=Куплю а/м "Buccaneer" за $
кбукхц=Куплю а/м "Buccaneer"[[курсор]] за $
кбукх=Куплю а/м "Buccaneer"[[курсор]]
кбук=Куплю а/м "Buccaneer"
кбуфц=Куплю а/м "Buffalo" за $
кбуфхц=Куплю а/м "Buffalo"[[курсор]] за $
кбуфх=Куплю а/м "Buffalo"[[курсор]]
кбуф=Куплю а/м "Buffalo"
кбалц=Куплю а/м "Bullet" за $
кбулц=Куплю а/м "Bullet" за $
кбалхц=Куплю а/м "Bullet"[[курсор]] за $
кбулхц=Куплю а/м "Bullet"[[курсор]] за $
кбалх=Куплю а/м "Bullet"[[курсор]]
кбулх=Куплю а/м "Bullet"[[курсор]]
кбал=Куплю а/м "Bullet"
кбул=Куплю а/м "Bullet"
кбурц=Куплю а/м "Burrito" за $
кбурхц=Куплю а/м "Burrito"[[курсор]] за $
кбурх=Куплю а/м "Burrito"[[курсор]]
кбур=Куплю а/м "Burrito"
ккадиц=Куплю а/м "Caddy" за $
ккадихц=Куплю а/м "Caddy"[[курсор]] за $
ккадих=Куплю а/м "Caddy"[[курсор]]
ккади=Куплю а/м "Caddy"
ккадилц=Куплю а/м "Cadillac XT6" за $
ккадилхц=Куплю а/м "Cadillac XT6"[[курсор]] за $
ккадилх=Куплю а/м "Cadillac XT6"[[курсор]]
ккадил=Куплю а/м "Cadillac XT6"
ккадрц=Куплю а/м "Cadrona" за $
ккадрх=Куплю а/м "Cadrona"[[курсор]]
ккадрхц=Куплю а/м "Cadrona"[] за $
ккадр=Куплю а/м "Cadrona"
ккамц=Куплю а/м "Camper" за $
ккамхц=Куплю а/м "Camper"[[курсор]] за $
ккамх=Куплю а/м "Camper"[[курсор]]
ккам=Куплю а/м "Camper"
кчитц=Куплю а/м "Cheetah" за $
кчитхц=Куплю а/м "Cheetah"[[курсор]] за $
кчитх=Куплю а/м "Cheetah"[[курсор]]
кчит=Куплю а/м "Cheetah"
ккамароц=Куплю а/м "Chevrolet Camaro" за $
ккамарохц=Куплю а/м "Chevrolet Camaro"[[курсор]] за $
ккамарох=Куплю а/м "Chevrolet Camaro"[[курсор]]
ккамаро=Куплю а/м "Chevrolet Camaro"
ккапризц=Куплю а/м "Chevrolet Caprice" за $
ккапризхц=Куплю а/м "Chevrolet Caprice"[[курсор]] за $
ккапризх=Куплю а/м "Chevrolet Caprice"[[курсор]]
ккаприз=Куплю а/м "Chevrolet Caprice"
ккорветц=Куплю а/м "Chevrolet Corvette C6" за $
ккорветхц=Куплю а/м "Chevrolet Corvette C6"[[курсор]] за $
ккорветх=Куплю а/м "Chevrolet Corvette C6"[[курсор]]
ккорвет=Куплю а/м "Chevrolet Corvette C6"
кимпалац=Куплю а/м "Chevrolet Impala 2018" за $
кимпалахц=Куплю а/м "Chevrolet Impala 2018"[[курсор]] за $
кимпалах=Куплю а/м "Chevrolet Impala 2018"[[курсор]]
кимпала=Куплю а/м "Chevrolet Impala 2018"
ктахоец=Куплю а/м "Chevrolet Tahoe" за $
ктахоехц=Куплю а/м "Chevrolet Tahoe"[[курсор]] за $
ктахоех=Куплю а/м "Chevrolet Tahoe"[[курсор]]
ктахое=Куплю а/м "Chevrolet Tahoe"
кклоц=Куплю а/м "Clover" за $
кклохц=Куплю а/м "Clover"[[курсор]] за $
кклох=Куплю а/м "Clover"[[курсор]]
ккло=Куплю а/м "Clover"
кклац=Куплю а/м "Club" за $
кклахц=Куплю а/м "Club"[[курсор]] за $
кклах=Куплю а/м "Club"[[курсор]]
ккла=Куплю а/м "Club"
ккоачц=Куплю а/м "Coach" за $
ккоачхц=Куплю а/м "Coach"[[курсор]] за $
ккоачх=Куплю а/м "Coach"[[курсор]]
ккоач=Куплю а/м "Coach"
ккомц=Куплю а/м "Comet" за $
ккомхц=Куплю а/м "Comet"[[курсор]] за $
ккомх=Куплю а/м "Comet"[[курсор]]
кком=Куплю а/м "Comet"
кчарджртц=Куплю а/м "Dodge Charger R/T" за $
кчарджртхц=Куплю а/м "Dodge Charger R/T"[[курсор]] за $
кчарджртх=Куплю а/м "Dodge Charger R/T"[[курсор]]
кчарджрт=Куплю а/м "Dodge Charger R/T"
кчарджц=Куплю а/м "Dodge Charger" за $
кчарджхц=Куплю а/м "Dodge Charger"[[курсор]] за $
кчарджх=Куплю а/м "Dodge Charger"[[курсор]]
кчардж=Куплю а/м "Dodge Charger"
кдозерц=Куплю а/м "Dozer" за $
кдозерхц=Куплю а/м "Dozer"[[курсор]] за $
кдозерх=Куплю а/м "Dozer"[[курсор]]
кдозер=Куплю а/м "Dozer"
кдамперц=Куплю а/м "Dumper" за $
кдамперхц=Куплю а/м "Dumper"[[курсор]] за $
кдамперх=Куплю а/м "Dumper"[[курсор]]
кдампер=Куплю а/м "Dumper"
кдюнц=Куплю а/м "Duneride" за $
кдюнхц=Куплю а/м "Duneride"[[курсор]] за $
кдюнх=Куплю а/м "Duneride"[[курсор]]
кдюн=Куплю а/м "Duneride"
келегац=Куплю а/м "Elegant" за $
келегахц=Куплю а/м "Elegant"[[курсор]] за $
келегах=Куплю а/м "Elegant"[[курсор]]
келега=Куплю а/м "Elegant"
келегиц=Куплю а/м "Elegy" за $
келегихц=Куплю а/м "Elegy"[[курсор]] за $
келегих=Куплю а/м "Elegy"[[курсор]]
келеги=Куплю а/м "Elegy"
кимпц=Куплю а/м "Emperor" за $
кимпхц=Куплю а/м "Emperor"[[курсор]] за $
кимпх=Куплю а/м "Emperor"[[курсор]]
кимп=Куплю а/м "Emperor"
кенфорц=Куплю а/м "Enforcer" за $
кенфорхц=Куплю а/м "Enforcer"[[курсор]] за $
кенфорх=Куплю а/м "Enforcer"[[курсор]]
кенфор=Куплю а/м "Enforcer"
кеспц=Куплю а/м "Esperanto" за $
кеспхц=Куплю а/м "Esperanto"[[курсор]] за $
кеспх=Куплю а/м "Esperanto"[[курсор]]
кесп=Куплю а/м "Esperanto"
кеврц=Куплю а/м "Euros" за $
кеврхц=Куплю а/м "Euros"[[курсор]] за $
кеврх=Куплю а/м "Euros"[[курсор]]
кевр=Куплю а/м "Euros"
кфбирц=Куплю а/м "FBI Rancher" за $
кфбирхц=Куплю а/м "FBI Rancher"[[курсор]] за $
кфбирх=Куплю а/м "FBI Rancher"[[курсор]]
кфбир=Куплю а/м "FBI Rancher"
кфбитц=Куплю а/м "FBI Truck" за $
кфбитхц=Куплю а/м "FBI Truck"[[курсор]] за $
кфбитх=Куплю а/м "FBI Truck"[[курсор]]
кфбит=Куплю а/м "FBI Truck"
кфелц=Куплю а/м "Feltzer" за $
кфелхц=Куплю а/м "Feltzer"[[курсор]] за $
кфелх=Куплю а/м "Feltzer"[[курсор]]
кфел=Куплю а/м "Feltzer"
кферц=Куплю а/м "Ferrari 488 GTB" за $
кферхц=Куплю а/м "Ferrari 488 GTB"[[курсор]] за $
кферх=Куплю а/м "Ferrari 488 GTB"[[курсор]]
кфер=Куплю а/м "Ferrari 488 GTB"
кфайрц=Куплю а/м "Firetruck" за $
кфайрхц=Куплю а/м "Firetruck"[[курсор]] за $
кфайрх=Куплю а/м "Firetruck"[[курсор]]
кфайр=Куплю а/м "Firetruck"
кфлец=Куплю а/м "Flash" за $
кфлехц=Куплю а/м "Flash"[[курсор]] за $
кфлех=Куплю а/м "Flash"[[курсор]]
кфле=Куплю а/м "Flash"
квикторияц=Куплю а/м "Ford Crown Victoria" за $
квикторияхц=Куплю а/м "Ford Crown Victoria"[[курсор]] за $
квикториях=Куплю а/м "Ford Crown Victoria"[[курсор]]
квиктория=Куплю а/м "Ford Crown Victoria"
кексплц=Куплю а/м "Ford Explorer" за $
кексплхц=Куплю а/м "Ford Explorer"[[курсор]] за $
кексплх=Куплю а/м "Ford Explorer"[[курсор]]
кекспл=Куплю а/м "Ford Explorer"
кмустангц=Куплю а/м "Ford Shelby Mustang" за $
кмустангхц=Куплю а/м "Ford Shelby Mustang"[[курсор]] за $
кмустангх=Куплю а/м "Ford Shelby Mustang"[[курсор]]
кмустанг=Куплю а/м "Ford Shelby Mustang"
ктаурусц=Куплю а/м "Ford Taurus" за $
ктаурусхц=Куплю а/м "Ford Taurus"[[курсор]] за $
ктаурусх=Куплю а/м "Ford Taurus"[[курсор]]
ктаурус=Куплю а/м "Ford Taurus"
кфорц=Куплю а/м "Fortune" за $
кфорхц=Куплю а/м "Fortune"[[курсор]] за $
кфорх=Куплю а/м "Fortune"[[курсор]]
кфор=Куплю а/м "Fortune"
кглендалшц=Куплю а/м "Glendale Shit" за $
кглендалшхц=Куплю а/м "Glendale Shit"[[курсор]] за $
кглендалшх=Куплю а/м "Glendale Shit"[[курсор]]
кглендалш=Куплю а/м "Glendale Shit"
кглец=Куплю а/м "Glendale" за $
кглехц=Куплю а/м "Glendale"[[курсор]] за $
кглех=Куплю а/м "Glendale"[[курсор]]
кгле=Куплю а/м "Glendale"
кгриц=Куплю а/м "Greenwood" за $
кгрихц=Куплю а/м "Greenwood"[[курсор]] за $
кгрих=Куплю а/м "Greenwood"[[курсор]]
кгри=Куплю а/м "Greenwood"
кгерц=Куплю а/м "Hermes" за $
кгерхц=Куплю а/м "Hermes"[[курсор]] за $
кгерх=Куплю а/м "Hermes"[[курсор]]
кгер=Куплю а/м "Hermes"
ксивикц=Куплю а/м "Honda Civic Gen 3" за $
ксивикхц=Куплю а/м "Honda Civic Gen 3"[[курсор]] за $
ксивикх=Куплю а/м "Honda Civic Gen 3"[[курсор]]
ксивик=Куплю а/м "Honda Civic Gen 3"
кхотнц=Куплю а/м "Hotknife" за $
кхотнхц=Куплю а/м "Hotknife"[[курсор]] за $
кхотнх=Куплю а/м "Hotknife"[[курсор]]
кхотн=Куплю а/м "Hotknife"
кхотац=Куплю а/м "Hotring Racer A" за $
кхотахц=Куплю а/м "Hotring Racer A"[[курсор]] за $
кхотах=Куплю а/м "Hotring Racer A"[[курсор]]
кхота=Куплю а/м "Hotring Racer A"
кхотбц=Куплю а/м "Hotring Racer B" за $
кхотбхц=Куплю а/м "Hotring Racer B"[[курсор]] за $
кхотбх=Куплю а/м "Hotring Racer B"[[курсор]]
кхотб=Куплю а/м "Hotring Racer B"
кхотц=Куплю а/м "Hotring Racer" за $
кхотхц=Куплю а/м "Hotring Racer"[[курсор]] за $
кхотх=Куплю а/м "Hotring Racer"[[курсор]]
кхот=Куплю а/м "Hotring Racer"
кхамц=Куплю а/м "Hummer H2" за $
кхамхц=Куплю а/м "Hummer H2"[[курсор]] за $
кхамх=Куплю а/м "Hummer H2"[[курсор]]
кхам=Куплю а/м "Hummer H2"
кханц=Куплю а/м "Huntley" за $
кханхц=Куплю а/м "Huntley"[[курсор]] за $
кханх=Куплю а/м "Huntley"[[курсор]]
кхан=Куплю а/м "Huntley"
кхасц=Куплю а/м "Hustler" за $
кхасхц=Куплю а/м "Hustler"[[курсор]] за $
кхасх=Куплю а/м "Hustler"[[курсор]]
кхас=Куплю а/м "Hustler"
кинфц=Куплю а/м "Infernus" за $
кинфхц=Куплю а/м "Infernus"[[курсор]] за $
кинфх=Куплю а/м "Infernus"[[курсор]]
кинф=Куплю а/м "Infernus"
кинфинц=Куплю а/м "Infinity FX35" за $
кинфинхц=Куплю а/м "Infinity FX35"[[курсор]] за $
кинфинх=Куплю а/м "Infinity FX35"[[курсор]]
кинфин=Куплю а/м "Infinity FX35"
кинтц=Куплю а/м "Intruder" за $
кинтхц=Куплю а/м "Intruder"[[курсор]] за $
кинтх=Куплю а/м "Intruder"[[курсор]]
кинт=Куплю а/м "Intruder"
кчирокиц=Куплю а/м "Jeep Cherokee SRT WK1" за $
кчирокихц=Куплю а/м "Jeep Cherokee SRT WK1"[[курсор]] за $
кчироких=Куплю а/м "Jeep Cherokee SRT WK1"[[курсор]]
кчироки=Куплю а/м "Jeep Cherokee SRT WK1"
кджц=Куплю а/м "Jester" за $
кджхц=Куплю а/м "Jester"[[курсор]] за $
кджх=Куплю а/м "Jester"[[курсор]]
кдж=Куплю а/м "Jester"
кджуц=Куплю а/м "Journey" за $
кджухц=Куплю а/м "Journey"[[курсор]] за $
кджух=Куплю а/м "Journey"[[курсор]]
кджу=Куплю а/м "Journey"
ккарц=Куплю а/м "Kart" за $
ккархц=Куплю а/м "Kart"[[курсор]] за $
ккарх=Куплю а/м "Kart"[[курсор]]
ккар=Куплю а/м "Kart"
к2107ц=Куплю а/м "Lada 2107" за $
к2107хц=Куплю а/м "Lada 2107"[[курсор]] за $
к2107х=Куплю а/м "Lada 2107"[[курсор]]
к2107=Куплю а/м "Lada 2107"
кприорац=Куплю а/м "Lada Priora" за $
кприорахц=Куплю а/м "Lada Priora"[[курсор]] за $
кприорах=Куплю а/м "Lada Priora"[[курсор]]
кприора=Куплю а/м "Lada Priora"
кламбц=Куплю а/м "Lamborghini Gallardo" за $
кламбхц=Куплю а/м "Lamborghini Gallardo"[[курсор]] за $
кламбх=Куплю а/м "Lamborghini Gallardo"[[курсор]]
кламб=Куплю а/м "Lamborghini Gallardo"
кланц=Куплю а/м "Landstalker" за $
кланхц=Куплю а/м "Landstalker"[[курсор]] за $
кланх=Куплю а/м "Landstalker"[[курсор]]
клан=Куплю а/м "Landstalker"
клекс3ц=Куплю а/м "Lexus IS300" за $
клекс3хц=Куплю а/м "Lexus IS300"[[курсор]] за $
клекс3х=Куплю а/м "Lexus IS300"[[курсор]]
клекс3=Куплю а/м "Lexus IS300"
клекс5ц=Куплю а/м "Lexus LS500" за $
клекс5хц=Куплю а/м "Lexus LS500"[[курсор]] за $
клекс5х=Куплю а/м "Lexus LS500"[[курсор]]
клекс5=Куплю а/м "Lexus LS500"
клайнерц=Куплю а/м "Linerunner" за $
клайнерхц=Куплю а/м "Linerunner"[[курсор]] за $
клайнерх=Куплю а/м "Linerunner"[[курсор]]
клайнер=Куплю а/м "Linerunner"
клвпдц=Куплю а/м "LVPD Police Car" за $
клвпдхц=Куплю а/м "LVPD Police Car"[[курсор]] за $
клвпдх=Куплю а/м "LVPD Police Car"[[курсор]]
клвпд=Куплю а/м "LVPD Police Car"
кмажц=Куплю а/м "Majestic" за $
кмажхц=Куплю а/м "Majestic"[[курсор]] за $
кмажх=Куплю а/м "Majestic"[[курсор]]
кмаж=Куплю а/м "Majestic"
кманц=Куплю а/м "Manana" за $
кманхц=Куплю а/м "Manana"[[курсор]] за $
кманх=Куплю а/м "Manana"[[курсор]]
кман=Куплю а/м "Manana"
кмерс190ц=Куплю а/м "Mercedes Benz 190E II" за $
кмерс190хц=Куплю а/м "Mercedes Benz 190E II"[[курсор]] за $
кмерс190х=Куплю а/м "Mercedes Benz 190E II"[[курсор]]
кмерс190=Куплю а/м "Mercedes Benz 190E II"
кмерсец=Куплю а/м "Mercedes Benz E-Class" за $
кмерсехц=Куплю а/м "Mercedes Benz E-Class"[[курсор]] за $
кмерсех=Куплю а/м "Mercedes Benz E-Class"[[курсор]]
кмерсе=Куплю а/м "Mercedes Benz E-Class"
кмерсгц=Куплю а/м "Mercedes Benz G-Class" за $
кмерсгхц=Куплю а/м "Mercedes Benz G-Class"[[курсор]] за $
кмерсгх=Куплю а/м "Mercedes Benz G-Class"[[курсор]]
кмерсг=Куплю а/м "Mercedes Benz G-Class"
кмерсслц=Куплю а/м "Mercedes Benz SL65" за $
кмерсслхц=Куплю а/м "Mercedes Benz SL65"[[курсор]] за $
кмерсслх=Куплю а/м "Mercedes Benz SL65"[[курсор]]
кмерссл=Куплю а/м "Mercedes Benz SL65"
кмерсамгц=Куплю а/м "Mercedes Benz SLS AMG" за $
кмерсамгхц=Куплю а/м "Mercedes Benz SLS AMG"[[курсор]] за $
кмерсамгх=Куплю а/м "Mercedes Benz SLS AMG"[[курсор]]
кмерсамг=Куплю а/м "Mercedes Benz SLS AMG"
кмерс124ц=Куплю а/м "Mercedes Benz W124" за $
кмерс124хц=Куплю а/м "Mercedes Benz W124"[[курсор]] за $
кмерс124х=Куплю а/м "Mercedes Benz W124"[[курсор]]
кмерс124=Куплю а/м "Mercedes Benz W124"
кмерсрц=Куплю а/м "Mercedes R129" за $
кмерсрхц=Куплю а/м "Mercedes R129"[[курсор]] за $
кмерсрх=Куплю а/м "Mercedes R129"[[курсор]]
кмерср=Куплю а/м "Mercedes R129"
кмерц=Куплю а/м "Merit" за $
кмерхц=Куплю а/м "Merit"[[курсор]] за $
кмерх=Куплю а/м "Merit"[[курсор]]
кмер=Куплю а/м "Merit"
кмесц=Куплю а/м "Mesa" за $
кмесхц=Куплю а/м "Mesa"[[курсор]] за $
кмесх=Куплю а/м "Mesa"[[курсор]]
кмес=Куплю а/м "Mesa"
кмитсубц=Куплю а/м "Mitsubishi 3000GT" за $
кмитсубхц=Куплю а/м "Mitsubishi 3000GT"[[курсор]] за $
кмитсубх=Куплю а/м "Mitsubishi 3000GT"[[курсор]]
кмитсуб=Куплю а/м "Mitsubishi 3000GT"
кланс9ц=Куплю а/м "Mitsubishi Lancer Evo IX" за $
кланс9хц=Куплю а/м "Mitsubishi Lancer Evo IX"[[курсор]] за $
кланс9х=Куплю а/м "Mitsubishi Lancer Evo IX"[[курсор]]
кланс9=Куплю а/м "Mitsubishi Lancer Evo IX"
кланс10ц=Куплю а/м "Mitsubishi Lancer Evo X" за $
кланс10хц=Куплю а/м "Mitsubishi Lancer Evo X"[[курсор]] за $
кланс10х=Куплю а/м "Mitsubishi Lancer Evo X"[[курсор]]
кланс10=Куплю а/м "Mitsubishi Lancer Evo X"
кмонац=Куплю а/м "Monster Truck A" за $
кмонахц=Куплю а/м "Monster Truck A"[[курсор]] за $
кмонах=Куплю а/м "Monster Truck A"[[курсор]]
кмона=Куплю а/м "Monster Truck A"
кмонбц=Куплю а/м "Monster Truck B" за $
кмонбхц=Куплю а/м "Monster Truck B"[[курсор]] за $
кмонбх=Куплю а/м "Monster Truck B"[[курсор]]
кмонб=Куплю а/м "Monster Truck B"
кмонц=Куплю а/м "Monster Truck" за $
кмонхц=Куплю а/м "Monster Truck"[[курсор]] за $
кмонх=Куплю а/м "Monster Truck"[[курсор]]
кмон=Куплю а/м "Monster Truck"
кмунц=Куплю а/м "Moonbeam" за $
кмунхц=Куплю а/м "Moonbeam"[[курсор]] за $
кмунх=Куплю а/м "Moonbeam"[[курсор]]
кмун=Куплю а/м "Moonbeam"
кмовц=Куплю а/м "Mower" за $
кмовхц=Куплю а/м "Mower"[[курсор]] за $
кмовх=Куплю а/м "Mower"[[курсор]]
кмов=Куплю а/м "Mower"
кнебц=Куплю а/м "Nebula" за $
кнебхц=Куплю а/м "Nebula"[[курсор]] за $
кнебх=Куплю а/м "Nebula"[[курсор]]
кнеб=Куплю а/м "Nebula"
кокец=Куплю а/м "Oceanic" за $
кокехц=Куплю а/м "Oceanic"[[курсор]] за $
кокех=Куплю а/м "Oceanic"[[курсор]]
коке=Куплю а/м "Oceanic"
кпатрц=Куплю а/м "Patriot" за $
кпатрхц=Куплю а/м "Patriot"[[курсор]] за $
кпатрх=Куплю а/м "Patriot"[[курсор]]
кпатр=Куплю а/м "Patriot"
кперц=Куплю а/м "Perennial" за $
кперхц=Куплю а/м "Perennial"[[курсор]] за $
кперх=Куплю а/м "Perennial"[[курсор]]
кпер=Куплю а/м "Perennial"
кфенц=Куплю а/м "Phoenix" за $
кфоец=Куплю а/м "Phoenix" за[курсор] $
кфенхц=Куплю а/м "Phoenix"[[курсор]] за $
кфоехц=Куплю а/м "Phoenix"[[курсор]] за $
кфенх=Куплю а/м "Phoenix"[[курсор]]
кфоех=Куплю а/м "Phoenix"[[курсор]]
кфен=Куплю а/м "Phoenix"
кфое=Куплю а/м "Phoenix"
крангерц=Куплю а/м "Police Ranger" за $
крангерхц=Куплю а/м "Police Ranger"[[курсор]] за $
крангерх=Куплю а/м "Police Ranger"[[курсор]]
крангер=Куплю а/м "Police Ranger"
кпоршц=Куплю а/м "Porsche 911 GT2" за $
кпоршхц=Куплю а/м "Porsche 911 GT2"[[курсор]] за $
кпоршх=Куплю а/м "Porsche 911 GT2"[[курсор]]
кпорш=Куплю а/м "Porsche 911 GT2"
кпрец=Куплю а/м "Premier" за $
кпрехц=Куплю а/м "Premier"[[курсор]] за $
кпрех=Куплю а/м "Premier"[[курсор]]
кпре=Куплю а/м "Premier"
кпревц=Куплю а/м "Previon" за $
кпревхц=Куплю а/м "Previon"[[курсор]] за $
кпревх=Куплю а/м "Previon"[[курсор]]
кпрев=Куплю а/м "Previon"
кприц=Куплю а/м "Primo" за $
кприхц=Куплю а/м "Primo"[[курсор]] за $
кприх=Куплю а/м "Primo"[[курсор]]
кпри=Куплю а/м "Primo"
кранц=Куплю а/м "Rancher" за $
кранхц=Куплю а/м "Rancher"[[курсор]] за $
кранх=Куплю а/м "Rancher"[[курсор]]
кран=Куплю а/м "Rancher"
кроверц=Куплю а/м "Range Rover" за $
кроверхц=Куплю а/м "Range Rover"[[курсор]] за $
кроверх=Куплю а/м "Range Rover"[[курсор]]
кровер=Куплю а/м "Range Rover"
крегц=Куплю а/м "Regina" за $
крегхц=Куплю а/м "Regina"[[курсор]] за $
крегх=Куплю а/м "Regina"[[курсор]]
крег=Куплю а/м "Regina"
кремхц=Куплю а/м "Remington" за $
кремц=Куплю а/м "Remington" за $
кремх=Куплю а/м "Remington"[[курсор]]
крем=Куплю а/м "Remington"
кроллсц=Куплю а/м "Rolls-Royce Phantom 7" за $
кроллсхц=Куплю а/м "Rolls-Royce Phantom 7"[[курсор]] за $
кроллсх=Куплю а/м "Rolls-Royce Phantom 7"[[курсор]]
кроллс=Куплю а/м "Rolls-Royce Phantom 7"
кромц=Куплю а/м "Romero" за $
кромхц=Куплю а/м "Romero"[[курсор]] за $
кромх=Куплю а/м "Romero"[[курсор]]
кром=Куплю а/м "Romero"
ксватц=Куплю а/м "S.W.A.T Van" за $
ксватхц=Куплю а/м "S.W.A.T Van"[[курсор]] за $
ксватх=Куплю а/м "S.W.A.T Van"[[курсор]]
ксват=Куплю а/м "S.W.A.T Van"
ксабц=Куплю а/м "Sabre" за $
ксабхц=Куплю а/м "Sabre"[[курсор]] за $
ксабх=Куплю а/м "Sabre"[[курсор]]
ксаб=Куплю а/м "Sabre"
ксандц=Куплю а/м "Sandking" за $
ксандхц=Куплю а/м "Sandking"[[курсор]] за $
ксандх=Куплю а/м "Sandking"[[курсор]]
ксанд=Куплю а/м "Sandking"
ксавц=Куплю а/м "Savanna" за $
ксавхц=Куплю а/м "Savanna"[[курсор]] за $
ксавх=Куплю а/м "Savanna"[[курсор]]
ксав=Куплю а/м "Savanna"
ксенц=Куплю а/м "Sentinel" за $
ксенхц=Куплю а/м "Sentinel"[[курсор]] за $
ксенх=Куплю а/м "Sentinel"[[курсор]]
ксен=Куплю а/м "Sentinel"
ксфпдц=Куплю а/м "SFPD Police Car" за $
ксфпдхц=Куплю а/м "SFPD Police Car"[[курсор]] за $
ксфпдх=Куплю а/м "SFPD Police Car"[[курсор]]
ксфпд=Куплю а/м "SFPD Police Car"
кслац=Куплю а/м "Slamvan" за $
кслахц=Куплю а/м "Slamvan"[[курсор]] за $
кслах=Куплю а/м "Slamvan"[[курсор]]
ксла=Куплю а/м "Slamvan"
ксолц=Куплю а/м "Solair" за $
ксолхц=Куплю а/м "Solair"[[курсор]] за $
ксолх=Куплю а/м "Solair"[[курсор]]
ксол=Куплю а/м "Solair"
кстафц=Куплю а/м "Stafford" за $
кстафхц=Куплю а/м "Stafford"[[курсор]] за $
кстафх=Куплю а/м "Stafford"[[курсор]]
кстаф=Куплю а/м "Stafford"
ксталц=Куплю а/м "Stallion" за $
ксталхц=Куплю а/м "Stallion"[[курсор]] за $
ксталх=Куплю а/м "Stallion"[[курсор]]
кстал=Куплю а/м "Stallion"
кстрац=Куплю а/м "Stratum" за $
кстрахц=Куплю а/м "Stratum"[[курсор]] за $
кстрах=Куплю а/м "Stratum"[[курсор]]
кстра=Куплю а/м "Stratum"
кстрец=Куплю а/м "Stretch" за $
кстрехц=Куплю а/м "Stretch"[[курсор]] за $
кстрех=Куплю а/м "Stretch"[[курсор]]
кстре=Куплю а/м "Stretch"
ксубаруц=Куплю а/м "Subaru Impreza STI" за $
ксубарухц=Куплю а/м "Subaru Impreza STI"[[курсор]] за $
ксубарух=Куплю а/м "Subaru Impreza STI"[[курсор]]
ксубару=Куплю а/м "Subaru Impreza STI"
ксулц=Куплю а/м "Sultan" за $
ксулхц=Куплю а/м "Sultan"[[курсор]] за $
ксулх=Куплю а/м "Sultan"[[курсор]]
ксул=Куплю а/м "Sultan"
ксанц=Куплю а/м "Sunrise" за $
ксанхц=Куплю а/м "Sunrise"[[курсор]] за $
ксанх=Куплю а/м "Sunrise"[[курсор]]
ксан=Куплю а/м "Sunrise"
ксупц=Куплю а/м "Super GT" за $
ксупхц=Куплю а/м "Super GT"[[курсор]] за $
ксупх=Куплю а/м "Super GT"[[курсор]]
ксуп=Куплю а/м "Super GT"
ктахц=Куплю а/м "Tahoma" за $
ктаххц=Куплю а/м "Tahoma"[[курсор]] за $
ктахх=Куплю а/м "Tahoma"[[курсор]]
ктах=Куплю а/м "Tahoma"
ктамц=Куплю а/м "Tampa" за $
ктамхц=Куплю а/м "Tampa"[[курсор]] за $
ктамх=Куплю а/м "Tampa"[[курсор]]
ктам=Куплю а/м "Tampa"
кторц=Куплю а/м "Tornado" за $
кторхц=Куплю а/м "Tornado"[[курсор]] за $
кторх=Куплю а/м "Tornado"[[курсор]]
ктор=Куплю а/м "Tornado"
ккамриц=Куплю а/м "Toyota Camry 3.5" за $
ккамрихц=Куплю а/м "Toyota Camry 3.5"[[курсор]] за $
ккамрих=Куплю а/м "Toyota Camry 3.5"[[курсор]]
ккамри=Куплю а/м "Toyota Camry 3.5"
ккоролц=Куплю а/м "Toyota Corolla GT-S" за $
ккоролхц=Куплю а/м "Toyota Corolla GT-S"[[курсор]] за $
ккоролх=Куплю а/м "Toyota Corolla GT-S"[[курсор]]
ккорол=Куплю а/м "Toyota Corolla GT-S"
ксуп8ц=Куплю а/м "Toyota Supra A80" за $
ксуп8хц=Куплю а/м "Toyota Supra A80"[[курсор]] за $
ксуп8х=Куплю а/м "Toyota Supra A80"[[курсор]]
ксуп8=Куплю а/м "Toyota Supra A80"
ксуп9ц=Куплю а/м "Toyota Supra A90" за $
ксуп9хц=Куплю а/м "Toyota Supra A90"[[курсор]] за $
ксуп9х=Куплю а/м "Toyota Supra A90"[[курсор]]
ксуп9=Куплю а/м "Toyota Supra A90"
ктракц=Куплю а/м "Tractor" за $
ктракхц=Куплю а/м "Tractor"[[курсор]] за $
ктракх=Куплю а/м "Tractor"[[курсор]]
ктрак=Куплю а/м "Tractor"
ктагц=Куплю а/м "Tug" за $
ктагхц=Куплю а/м "Tug"[[курсор]] за $
ктагх=Куплю а/м "Tug"[[курсор]]
ктаг=Куплю а/м "Tug"
ктурц=Куплю а/м "Turismo" за $
ктурхц=Куплю а/м "Turismo"[[курсор]] за $
ктурх=Куплю а/м "Turismo"[[курсор]]
ктур=Куплю а/м "Turismo"
курац=Куплю а/м "Uranus" за $
курахц=Куплю а/м "Uranus"[[курсор]] за $
курах=Куплю а/м "Uranus"[[курсор]]
кура=Куплю а/м "Uranus"
квинцц=Куплю а/м "Vincent" за $
квинцхц=Куплю а/м "Vincent"[[курсор]] за $
квинцх=Куплю а/м "Vincent"[[курсор]]
квинц=Куплю а/м "Vincent"
квирц=Куплю а/м "Virgo" за $
квирхц=Куплю а/м "Virgo"[[курсор]] за $
квирх=Куплю а/м "Virgo"[[курсор]]
квир=Куплю а/м "Virgo"
кпасц=Куплю а/м "Volkswagen Passat CC" за $
кпасхц=Куплю а/м "Volkswagen Passat CC"[[курсор]] за $
кпасх=Куплю а/м "Volkswagen Passat CC"[[курсор]]
кпас=Куплю а/м "Volkswagen Passat CC"
квудц=Куплю а/м "Voodoo" за $
квудхц=Куплю а/м "Voodoo"[[курсор]] за $
квудх=Куплю а/м "Voodoo"[[курсор]]
квуд=Куплю а/м "Voodoo"
квашц=Куплю а/м "Washington" за $
квашхц=Куплю а/м "Washington"[[курсор]] за $
квашх=Куплю а/м "Washington"[[курсор]]
кваш=Куплю а/м "Washington"
квилц=Куплю а/м "Willard" за $
квилхц=Куплю а/м "Willard"[[курсор]] за $
квилх=Куплю а/м "Willard"[[курсор]]
квил=Куплю а/м "Willard"
квиндц=Куплю а/м "Windsor" за $
квиндхц=Куплю а/м "Windsor"[[курсор]] за $
квиндх=Куплю а/м "Windsor"[[курсор]]
квинд=Куплю а/м "Windsor"
кюсехц=Куплю а/м "Yosemite"[[курсор]] за $
кюсех=Куплю а/м "Yosemite"[[курсор]]
кюсе=Куплю а/м "Yosemite"
кзрц=Куплю а/м "ZR-350" за $
кзрхц=Куплю а/м "ZR-350"[[курсор]] за $
кзрх=Куплю а/м "ZR-350"[[курсор]]
кзр=Куплю а/м "ZR-350"
кац=Куплю автомобиль любой марки за $
кахц=Куплю автомобиль любой марки[[курсор]] за $
ках=Куплю автомобиль любой марки[[курсор]]
ка=Куплю автомобиль любой марки
кедптц=Куплю амуницию в размере [курсор] единиц за $
кхптц=Куплю амуницию в размере [курсор] единиц за $
кедпт=Куплю амуницию в размере [курсор] единиц
кхпт=Куплю амуницию в размере [курсор] единиц
кптц=Куплю амуницию для страйкбола за $
кпт=Куплю амуницию для страйкбола
кигрушкиц=Куплю антистресс-игрушки за $
кигрушки=Куплю антистресс-игрушки
кигрхц=Куплю антистресс-игрушку "[курсор]" за $
кигрх=Куплю антистресс-игрушку "[курсор]"
кпопитц=Куплю антистресс-игрушку "Поп ит" за $
кпопит=Куплю антистресс-игрушку "Поп ит"
ксимплц=Куплю антистресс-игрушку "Симпл димпл" за $
ксимпл=Куплю антистресс-игрушку "Симпл димпл"
кспинц=Куплю антистресс-игрушку "Спиннер" за $
кспин=Куплю антистресс-игрушку "Спиннер"
кбхгдец=Куплю бизнес "[курсор]"  за $
кбхгде=Куплю бизнес "[курсор]" 
кбхц=Куплю бизнес "[курсор]" за $
кбх=Куплю бизнес "[курсор]"
кмастхц=Куплю бизнес "Автомастерская"  за $
кмастх=Куплю бизнес "Автомастерская" 
кмастц=Куплю бизнес "Автомастерская" за $
кмаст=Куплю бизнес "Автомастерская"
ккомфц=Куплю бизнес "Автосалон Комфорт" за $
ккомф=Куплю бизнес "Автосалон Комфорт"
кэкоц=Куплю бизнес "Автосалон Эконом" за $
кэко=Куплю бизнес "Автосалон Эконом"
кэлитц=Куплю бизнес "Автосалон Элитный" за $
кэлит=Куплю бизнес "Автосалон Элитный"
казсхц=Куплю бизнес "АЗС"  за $
казсх=Куплю бизнес "АЗС" 
казсц=Куплю бизнес "АЗС" за $
казс=Куплю бизнес "АЗС"
кбархц=Куплю бизнес "Бар" [курсор] за $
кбарх=Куплю бизнес "Бар" 
кбарц=Куплю бизнес "Бар" за $
кбар=Куплю бизнес "Бар"
квелоц=Куплю бизнес "Велосалон" за $
квело=Куплю бизнес "Велосалон"
кврсхц=Куплю бизнес "Воздушные RC игрушки" [курсор] за $
кврсх=Куплю бизнес "Воздушные RC игрушки" 
кврсц=Куплю бизнес "Воздушные RC игрушки" за $
кврс=Куплю бизнес "Воздушные RC игрушки"
кджетц=Куплю бизнес "Джетпак" за $
кджет=Куплю бизнес "Джетпак"
кзакхц=Куплю бизнес "Закусочная" [курсор] за $
кзакх=Куплю бизнес "Закусочная" 
кзакц=Куплю бизнес "Закусочная" за $
кзак=Куплю бизнес "Закусочная"
ккорц=Куплю бизнес "Корабль" за $
ккор=Куплю бизнес "Корабль"
к247хц=Куплю бизнес "Магазин 24/7"  за $
кмагхц=Куплю бизнес "Магазин 24/7"  за $
к247х=Куплю бизнес "Магазин 24/7" 
кмагх=Куплю бизнес "Магазин 24/7" 
к247ц=Куплю бизнес "Магазин 24/7" за $
кмагц=Куплю бизнес "Магазин 24/7" за $
к247=Куплю бизнес "Магазин 24/7"
кмаг=Куплю бизнес "Магазин 24/7"
каксхц=Куплю бизнес "Магазин аксессуаров" [курсор] за $
каксх=Куплю бизнес "Магазин аксессуаров" 
каксц=Куплю бизнес "Магазин аксессуаров" за $
какс=Куплю бизнес "Магазин аксессуаров"
кодежхц=Куплю бизнес "Магазин одежды" [курсор] за $
кодежх=Куплю бизнес "Магазин одежды" 
кодежц=Куплю бизнес "Магазин одежды" за $
кодеж=Куплю бизнес "Магазин одежды"
кхипиц=Куплю бизнес "Магазин Hippi" за $
кхиппиц=Куплю бизнес "Магазин Hippi" за $
кхипи=Куплю бизнес "Магазин Hippi"
кхиппи=Куплю бизнес "Магазин Hippi"
кмотоц=Куплю бизнес "Мотосалон" за $
кмото=Куплю бизнес "Мотосалон"
коружхц=Куплю бизнес "Оружейный магазин" [курсор] за $
коружх=Куплю бизнес "Оружейный магазин" 
коружц=Куплю бизнес "Оружейный магазин" за $
коруж=Куплю бизнес "Оружейный магазин"
кпарашютц=Куплю бизнес "Парашютные прыжки" за $
кпарашют=Куплю бизнес "Парашютные прыжки"
кпарикхц=Куплю бизнес "Парикмахерская"  за $
кпарикх=Куплю бизнес "Парикмахерская" 
кпарикц=Куплю бизнес "Парикмахерская" за $
кпарик=Куплю бизнес "Парикмахерская"
кпенц=Куплю бизнес "Пенек" за $
кпен=Куплю бизнес "Пенек"
кпироц=Куплю бизнес "Пиротехника" за $
ксалютц=Куплю бизнес "Пиротехника" за $
кпиро=Куплю бизнес "Пиротехника"
ксалют=Куплю бизнес "Пиротехника"
кпочхц=Куплю бизнес "Починка транспорта" [курсор] за $
кпочх=Куплю бизнес "Починка транспорта" 
кпочц=Куплю бизнес "Починка транспорта" за $
кпоч=Куплю бизнес "Починка транспорта"
кагентц=Куплю бизнес "Риэлторское агенство" за $
кагент=Куплю бизнес "Риэлторское агенство"
крыбц=Куплю бизнес "Рыболовный магазин" за $
крыб=Куплю бизнес "Рыболовный магазин"
ксигхц=Куплю бизнес "Табачный магазин" [курсор] за $
ктабакхц=Куплю бизнес "Табачный магазин" [курсор] за $
ксигх=Куплю бизнес "Табачный магазин" 
ктабакх=Куплю бизнес "Табачный магазин" 
ксигц=Куплю бизнес "Табачный магазин" за $
ктабакц=Куплю бизнес "Табачный магазин" за $
ксиг=Куплю бизнес "Табачный магазин"
ктабак=Куплю бизнес "Табачный магазин"
крсхц=Куплю бизнес "RC игрушки" [курсор] за $
крсх=Куплю бизнес "RC игрушки" 
крсц=Куплю бизнес "RC игрушки" за $
крс=Куплю бизнес "RC игрушки"
кбгдец=Куплю бизнес [курсор] за $
кбгде=Куплю бизнес 
кбц=Куплю бизнес за $
кб=Куплю бизнес
квмц=Куплю в/м "[курсор]" за $
квм=Куплю в/м "[курсор]"
кбайц=Куплю в/м "Bike" за $
квбц=Куплю в/м "Bike" за $
кбайк=Куплю в/м "Bike"
квб=Куплю в/м "Bike"
кбмхц=Куплю в/м "BMX" за $
квбмхц=Куплю в/м "BMX" за $
кбмх=Куплю в/м "BMX"
квбмх=Куплю в/м "BMX"
квгц=Куплю в/м "Mountain Bike" за $
квмбц=Куплю в/м "Mountain Bike" за $
кгорц=Куплю в/м "Mountain Bike" за $
квг=Куплю в/м "Mountain Bike"
квмб=Куплю в/м "Mountain Bike"
кгор=Куплю в/м "Mountain Bike"
кпеннифц=Куплю в/м "Penny farthing" за $
кпенниф=Куплю в/м "Penny farthing"
квц=Куплю велосипед любой марки за $
кв=Куплю велосипед любой марки
кпазлц=Куплю головоломку "Пазл" за $
кпазл=Куплю головоломку "Пазл"
кпятнц=Куплю головоломку "Пятнашки" за $
кпятн=Куплю головоломку "Пятнашки"
кбашц=Куплю головоломку "Ханойская башня" за $
кбаш=Куплю головоломку "Ханойская башня"
кпетухц=Куплю декоративную птицу за $
кпетух=Куплю декоративную птицу
кдрц=Куплю дерево за $
кдр=Куплю дерево
кд1орц=Куплю дом 1-го класса в "Опасном районе" за $
кд1ор=Куплю дом 1-го класса в "Опасном районе"
кд1вмфц=Куплю дом 1-го класса в военном городке за $
кд1вмф=Куплю дом 1-го класса в военном городке
кд1лвц=Куплю дом 1-го класса в г. Лас-Вентурас за $
кд1лв=Куплю дом 1-го класса в г. Лас-Вентурас
кд1лсц=Куплю дом 1-го класса в г. Лос-Сантос за $
кд1лс=Куплю дом 1-го класса в г. Лос-Сантос
кд1сфц=Куплю дом 1-го класса в г. Сан-Фиерро за $
кд1сф=Куплю дом 1-го класса в г. Сан-Фиерро
кд1прлвц=Куплю дом 1-го класса в пригороде Лас-Вентураса за $
кд1прлв=Куплю дом 1-го класса в пригороде Лас-Вентураса
кд1прлсц=Куплю дом 1-го класса в пригороде Лос-Сантоса за $
кд1прлс=Куплю дом 1-го класса в пригороде Лос-Сантоса
кд1прсфц=Куплю дом 1-го класса в пригороде Сан-Фиерро за $
кд1прсф=Куплю дом 1-го класса в пригороде Сан-Фиерро
кд1ввсц=Куплю дом 1-го класса в пустыне за $
кд1свц=Куплю дом 1-го класса в пустыне за $
кд1ввс=Куплю дом 1-го класса в пустыне
кд1св=Куплю дом 1-го класса в пустыне
кд1ппц=Куплю дом 1-го класса в районе "Prickle Pine" за $
кд1пп=Куплю дом 1-го класса в районе "Prickle Pine"
кд1ц=Куплю дом 1-го класса за $
кд1ввц=Куплю дом 1-го класса на горе "VineWood" за $
кд1вв=Куплю дом 1-го класса на горе "VineWood"
кд1смц=Куплю дом 1-го класса на пляже "Санта-Мария" за $
кд1см=Куплю дом 1-го класса на пляже "Санта-Мария"
кд1=Куплю дом 1-го класса
кд2орц=Куплю дом 2-го класса в "Опасном районе" за $
кд2ор=Куплю дом 2-го класса в "Опасном районе"
кд2вмфц=Куплю дом 2-го класса в военном городке за $
кд2вмф=Куплю дом 2-го класса в военном городке
кд2лвц=Куплю дом 2-го класса в г. Лас-Вентурас за $
кд2лв=Куплю дом 2-го класса в г. Лас-Вентурас
кд2лсц=Куплю дом 2-го класса в г. Лос-Сантос за $
кд2лс=Куплю дом 2-го класса в г. Лос-Сантос
кд2сфц=Куплю дом 2-го класса в г. Сан-Фиерро за $
кд2сф=Куплю дом 2-го класса в г. Сан-Фиерро
кд2прлвц=Куплю дом 2-го класса в пригороде Лас-Вентураса за $
кд2прлв=Куплю дом 2-го класса в пригороде Лас-Вентураса
кд2прлсц=Куплю дом 2-го класса в пригороде Лос-Сантоса за $
кд2прлс=Куплю дом 2-го класса в пригороде Лос-Сантоса
кд2прсфц=Куплю дом 2-го класса в пригороде Сан-Фиерро за $
кд2прсф=Куплю дом 2-го класса в пригороде Сан-Фиерро
кд2ввсц=Куплю дом 2-го класса в пустыне за $
кд2свц=Куплю дом 2-го класса в пустыне за $
кд2ввс=Куплю дом 2-го класса в пустыне
кд2св=Куплю дом 2-го класса в пустыне
кд2пкрц=Куплю дом 2-го класса в районе "Palomino Creek" за $
кд2пкр=Куплю дом 2-го класса в районе "Palomino Creek"
кд2ппц=Куплю дом 2-го класса в районе "Prickle Pine" за $
кд2пп=Куплю дом 2-го класса в районе "Prickle Pine"
кд2ц=Куплю дом 2-го класса за $
кд2ввц=Куплю дом 2-го класса на горе "VineWood" за $
кд2вв=Куплю дом 2-го класса на горе "VineWood"
кд2смц=Куплю дом 2-го класса на пляже "Санта-Мария" за $
кд2=Куплю дом 2-го класса
кд3орц=Куплю дом 3-го класса в "Опасном районе" за $
кд3ор=Куплю дом 3-го класса в "Опасном районе"
кд3вмфц=Куплю дом 3-го класса в военном городке за $
кд3вмф=Куплю дом 3-го класса в военном городке
кд3лвц=Куплю дом 3-го класса в г. Лас-Вентурас за $
кд3лв=Куплю дом 3-го класса в г. Лас-Вентурас
кд3лсц=Куплю дом 3-го класса в г. Лос-Сантос за $
кд3сфц=Куплю дом 3-го класса в г. Сан-Фиерро за $
кд3сф=Куплю дом 3-го класса в г. Сан-Фиерро
кд3прлвц=Куплю дом 3-го класса в пригороде Лас-Вентураса за $
кд3прлв=Куплю дом 3-го класса в пригороде Лас-Вентураса
кд3прлсц=Куплю дом 3-го класса в пригороде Лос-Сантоса за $
кд3прлс=Куплю дом 3-го класса в пригороде Лос-Сантоса
кд3прсфц=Куплю дом 3-го класса в пригороде Сан-Фиерро за $
кд3прсф=Куплю дом 3-го класса в пригороде Сан-Фиерро
кд3ввсц=Куплю дом 3-го класса в пустыне за $
кд3свц=Куплю дом 3-го класса в пустыне за $
кд3ввс=Куплю дом 3-го класса в пустыне
кд3св=Куплю дом 3-го класса в пустыне
кд3ппц=Куплю дом 3-го класса в районе "Prickle Pine" за $
кд3пп=Куплю дом 3-го класса в районе "Prickle Pine"
кд3ц=Куплю дом 3-го класса за $
кд3ввц=Куплю дом 3-го класса на горе "VineWood" за $
кд3вв=Куплю дом 3-го класса на горе "VineWood"
кд3смц=Куплю дом 3-го класса на пляже "Санта-Мария" за $
кд3см=Куплю дом 3-го класса на пляже "Санта-Мария"
кд3=Куплю дом 3-го класса
кд4орц=Куплю дом 4-го класса в "Опасном районе" за $
кд4ор=Куплю дом 4-го класса в "Опасном районе"
кд4вмфц=Куплю дом 4-го класса в военном городке за $
кд4вмф=Куплю дом 4-го класса в военном городке
кд4лвц=Куплю дом 4-го класса в г. Лас-Вентурас за $
кд4лв=Куплю дом 4-го класса в г. Лас-Вентурас
кд4лсц=Куплю дом 4-го класса в г. Лос-Сантос за $
кд4лс=Куплю дом 4-го класса в г. Лос-Сантос
кд4сфц=Куплю дом 4-го класса в г. Сан-Фиерро за $
кд4сф=Куплю дом 4-го класса в г. Сан-Фиерро
кд4прлвц=Куплю дом 4-го класса в пригороде Лас-Вентураса за $
кд4прлв=Куплю дом 4-го класса в пригороде Лас-Вентураса
кд4прлсц=Куплю дом 4-го класса в пригороде Лос-Сантоса за $
кд4прлс=Куплю дом 4-го класса в пригороде Лос-Сантоса
кд4прсфц=Куплю дом 4-го класса в пригороде Сан-Фиерро за $
кд4прсф=Куплю дом 4-го класса в пригороде Сан-Фиерро
кд4ввсц=Куплю дом 4-го класса в пустыне за $
кд4свц=Куплю дом 4-го класса в пустыне за $
кд4ввс=Куплю дом 4-го класса в пустыне
кд4св=Куплю дом 4-го класса в пустыне
кд4ппц=Куплю дом 4-го класса в районе "Prickle Pine" за $
кд4пп=Куплю дом 4-го класса в районе "Prickle Pine"
кд4ц=Куплю дом 4-го класса за $
кд4ввц=Куплю дом 4-го класса на горе "VineWood" за $
кд4вв=Куплю дом 4-го класса на горе "VineWood"
кд4смц=Куплю дом 4-го класса на пляже "Санта-Мария" за $
кд4см=Куплю дом 4-го класса на пляже "Санта-Мария"
кд4=Куплю дом 4-го класса
кд5орц=Куплю дом 5-го класса в "Опасном районе" за $
кд5ор=Куплю дом 5-го класса в "Опасном районе"
кд5вмфц=Куплю дом 5-го класса в военном городке за $
кд5вмф=Куплю дом 5-го класса в военном городке
кд5лвц=Куплю дом 5-го класса в г. Лас-Вентурас за $
кд5лв=Куплю дом 5-го класса в г. Лас-Вентурас
кд5лсц=Куплю дом 5-го класса в г. Лос-Сантос за $
кд5лс=Куплю дом 5-го класса в г. Лос-Сантос
кд5сфц=Куплю дом 5-го класса в г. Сан-Фиерро за $
кд5сф=Куплю дом 5-го класса в г. Сан-Фиерро
кд5прлвц=Куплю дом 5-го класса в пригороде Лас-Вентураса за $
кд5прлв=Куплю дом 5-го класса в пригороде Лас-Вентураса
кд5прлсц=Куплю дом 5-го класса в пригороде Лос-Сантоса за $
кд5прлс=Куплю дом 5-го класса в пригороде Лос-Сантоса
кд5прсфц=Куплю дом 5-го класса в пригороде Сан-Фиерро за $
кд5прсф=Куплю дом 5-го класса в пригороде Сан-Фиерро
кд5ввсц=Куплю дом 5-го класса в пустыне за $
кд5свц=Куплю дом 5-го класса в пустыне за $
кд5ввс=Куплю дом 5-го класса в пустыне
кд5св=Куплю дом 5-го класса в пустыне
кд5ппц=Куплю дом 5-го класса в районе "Prickle Pine" за $
кд5пп=Куплю дом 5-го класса в районе "Prickle Pine"
кд5ц=Куплю дом 5-го класса за $
кд5ввц=Куплю дом 5-го класса на горе "VineWood" за $
кд5вв=Куплю дом 5-го класса на горе "VineWood"
кд5смц=Куплю дом 5-го класса на пляже "Санта-Мария" за $
кд5см=Куплю дом 5-го класса на пляже "Санта-Мария"
кд5=Куплю дом 5-го класса
кд6орц=Куплю дом 6-го класса в "Опасном районе" за $
кд6ор=Куплю дом 6-го класса в "Опасном районе"
кд6вмфц=Куплю дом 6-го класса в военном городке за $
кд6вмф=Куплю дом 6-го класса в военном городке
кд6лвц=Куплю дом 6-го класса в г. Лас-Вентурас за $
кд6лв=Куплю дом 6-го класса в г. Лас-Вентурас
кд6лсц=Куплю дом 6-го класса в г. Лос-Сантос за $
кд6лс=Куплю дом 6-го класса в г. Лос-Сантос
кд6сфц=Куплю дом 6-го класса в г. Сан-Фиерро за $
кд6сф=Куплю дом 6-го класса в г. Сан-Фиерро
кд6прлвц=Куплю дом 6-го класса в пригороде Лас-Вентураса за $
кд6прлв=Куплю дом 6-го класса в пригороде Лас-Вентураса
кд6прлсц=Куплю дом 6-го класса в пригороде Лос-Сантоса за $
кд6прлс=Куплю дом 6-го класса в пригороде Лос-Сантоса
кд6прсфц=Куплю дом 6-го класса в пригороде Сан-Фиерро за $
кд6прсф=Куплю дом 6-го класса в пригороде Сан-Фиерро
кд6ввсц=Куплю дом 6-го класса в пустыне за $
кд6свц=Куплю дом 6-го класса в пустыне за $
кд6ввс=Куплю дом 6-го класса в пустыне
кд6св=Куплю дом 6-го класса в пустыне
кд6ппц=Куплю дом 6-го класса в районе "Prickle Pine" за $
кд6пп=Куплю дом 6-го класса в районе "Prickle Pine"
кд6ц=Куплю дом 6-го класса за $
кд6ввц=Куплю дом 6-го класса на горе "VineWood" за $
кд6вв=Куплю дом 6-го класса на горе "VineWood"
кд6смц=Куплю дом 6-го класса на пляже "Санта-Мария" за $
кд6см=Куплю дом 6-го класса на пляже "Санта-Мария"
кд6=Куплю дом 6-го класса
кдорц=Куплю дом в "Опасном районе" за $
кдор=Куплю дом в "Опасном районе"
кдвмфц=Куплю дом в военном городке за $
кдвмф=Куплю дом в военном городке
кдлвц=Куплю дом в г. Лас-Вентурас за $
кдлв=Куплю дом в г. Лас-Вентурас
кдлсц=Куплю дом в г. Лос-Сантос за $
кдлс=Куплю дом в г. Лос-Сантос
кдсфц=Куплю дом в г. Сан-Фиерро за $
кдсф=Куплю дом в г. Сан-Фиерро
кдпрлвц=Куплю дом в пригороде Лас-Вентураса за $
кдпрлв=Куплю дом в пригороде Лас-Вентураса
кдпрлсц=Куплю дом в пригороде Лос-Сантоса за $
кдпрлс=Куплю дом в пригороде Лос-Сантоса
кдпрсфц=Куплю дом в пригороде Сан-Фиерро за $
кдпрсф=Куплю дом в пригороде Сан-Фиерро
кдввсц=Куплю дом в пустыне за $
кдсвц=Куплю дом в пустыне за $
кдввс=Куплю дом в пустыне
кдсв=Куплю дом в пустыне
кдпкрц=Куплю дом в районе "Palomino Creek" за $
кдпкр=Куплю дом в районе "Palomino Creek"
кдппц=Куплю дом в районе "Prickle Pine" за $
кдпп=Куплю дом в районе "Prickle Pine"
кдц=Куплю дом за $
кдввц=Куплю дом на горе "VineWood" за $
кдвв=Куплю дом на горе "VineWood"
кдсмц=Куплю дом на пляже "Санта-Мария" за $
кдсм=Куплю дом на пляже "Санта-Мария"
кд=Куплю дом
кжц=Куплю железо за $
кж=Куплю железо
кхспортц=Куплю к/м "Honda Sportrax 250EX" за $
кхспортхц=Куплю к/м "Honda Sportrax 250EX"[[курсор]] за $
кхспортх=Куплю к/м "Honda Sportrax 250EX"[[курсор]]
кхспорт=Куплю к/м "Honda Sportrax 250EX"
кквц=Куплю к/м "Quad" за $
кквхц=Куплю к/м "Quad"[[курсор]] за $
кквх=Куплю к/м "Quad"[[курсор]]
ккв=Куплю к/м "Quad"
клц=Куплю любое транспортное средство за $
клхц=Куплю любое транспортное средство[[курсор]] за $
клх=Куплю любое транспортное средство[[курсор]]
кл=Куплю любое транспортное средство
кммц=Куплю м/м "[курсор]" за $
кммхц=Куплю м/м "[курсор]"[] за $
кммх=Куплю м/м "[курсор]"[]
кмм=Куплю м/м "[курсор]"
кбфц=Куплю м/м "BF-400" за $
кбфхц=Куплю м/м "BF-400"[[курсор]] за $
кбфх=Куплю м/м "BF-400"[[курсор]]
кбф=Куплю м/м "BF-400"
кбмврц=Куплю м/м "BMW R 1200RT" за $
кбмврхц=Куплю м/м "BMW R 1200RT"[[курсор]] за $
кбмврх=Куплю м/м "BMW R 1200RT"[[курсор]]
кбмвр=Куплю м/м "BMW R 1200RT"
кчоперц=Куплю м/м "Chopper" за $
кчоперхц=Куплю м/м "Chopper"[[курсор]] за $
кчоперх=Куплю м/м "Chopper"[[курсор]]
кчопер=Куплю м/м "Chopper"
кглайдц=Куплю м/м "Electra Glide" за $
кглайдхц=Куплю м/м "Electra Glide"[[курсор]] за $
кглайдх=Куплю м/м "Electra Glide"[[курсор]]
кглайд=Куплю м/м "Electra Glide"
кфагц=Куплю м/м "Faggio" за $
кфагхц=Куплю м/м "Faggio"[[курсор]] за $
кфагх=Куплю м/м "Faggio"[[курсор]]
кфаг=Куплю м/м "Faggio"
кфцрц=Куплю м/м "FCR-900" за $
кфцрхц=Куплю м/м "FCR-900"[[курсор]] за $
кфцрх=Куплю м/м "FCR-900"[[курсор]]
кфцр=Куплю м/м "FCR-900"
кфриц=Куплю м/м "Freeway" за $
кфрихц=Куплю м/м "Freeway"[[курсор]] за $
кфрих=Куплю м/м "Freeway"[[курсор]]
кфри=Куплю м/м "Freeway"
ккорнетц=Куплю м/м "Honda Cornet C8600F" за $
ккорнетхц=Куплю м/м "Honda Cornet C8600F"[[курсор]] за $
ккорнетх=Куплю м/м "Honda Cornet C8600F"[[курсор]]
ккорнет=Куплю м/м "Honda Cornet C8600F"
кдиоц=Куплю м/м "Honda Dio" за $
кдиохц=Куплю м/м "Honda Dio"[[курсор]] за $
кдиох=Куплю м/м "Honda Dio"[[курсор]]
кдио=Куплю м/м "Honda Dio"
кхорнетц=Куплю м/м "Honda Hornet C8600F" за $
кхорнетхц=Куплю м/м "Honda Hornet C8600F"[[курсор]] за $
кхорнетх=Куплю м/м "Honda Hornet C8600F"[[курсор]]
кхорнет=Куплю м/м "Honda Hornet C8600F"
кхондахрец=Куплю м/м "Honda XRE-300" за $
кхондахрехц=Куплю м/м "Honda XRE-300"[[курсор]] за $
кхондахрех=Куплю м/м "Honda XRE-300"[[курсор]]
кхондахре=Куплю м/м "Honda XRE-300"
киксрец=Куплю м/м "Honda XRE300" за $
киксрехц=Куплю м/м "Honda XRE300"[[курсор]] за $
киксрех=Куплю м/м "Honda XRE300"[[курсор]]
киксре=Куплю м/м "Honda XRE300"
кхпвц=Куплю м/м "HPV-1000" за $
кхпвхц=Куплю м/м "HPV-1000"[[курсор]] за $
кхпвх=Куплю м/м "HPV-1000"[[курсор]]
кхпв=Куплю м/м "HPV-1000"
ккаванц=Куплю м/м "Kawasaki NRR 1000" за $
ккаванхц=Куплю м/м "Kawasaki NRR 1000"[[курсор]] за $
ккаванх=Куплю м/м "Kawasaki NRR 1000"[[курсор]]
ккаван=Куплю м/м "Kawasaki NRR 1000"
ккавазц=Куплю м/м "Kawasaki Z400FX" за $
ккавазхц=Куплю м/м "Kawasaki Z400FX"[[курсор]] за $
ккавазх=Куплю м/м "Kawasaki Z400FX"[[курсор]]
ккаваз=Куплю м/м "Kawasaki Z400FX"
кнргррц=Куплю м/м "NRG 500RR" за $
кнргррхц=Куплю м/м "NRG 500RR"[[курсор]] за $
кнргррх=Куплю м/м "NRG 500RR"[[курсор]]
кнргрр=Куплю м/м "NRG 500RR"
кнргц=Куплю м/м "NRG-500" за $
кнргхц=Куплю м/м "NRG-500"[[курсор]] за $
кнргх=Куплю м/м "NRG-500"[[курсор]]
кнрг=Куплю м/м "NRG-500"
кпсжц=Куплю м/м "PCJ-600" за $
кпсжхц=Куплю м/м "PCJ-600"[[курсор]] за $
кпсжх=Куплю м/м "PCJ-600"[[курсор]]
кпсж=Куплю м/м "PCJ-600"
кпегасиц=Куплю м/м "Pegassi FCR 1000" за $
кпегасихц=Куплю м/м "Pegassi FCR 1000"[[курсор]] за $
кпегасих=Куплю м/м "Pegassi FCR 1000"[[курсор]]
кпегаси=Куплю м/м "Pegassi FCR 1000"
кпицц=Куплю м/м "Pizzaboy" за $
кпицхц=Куплю м/м "Pizzaboy"[[курсор]] за $
кпицх=Куплю м/м "Pizzaboy"[[курсор]]
кпиц=Куплю м/м "Pizzaboy"
ксанчц=Куплю м/м "Sanchez" за $
ксанчхц=Куплю м/м "Sanchez"[[курсор]] за $
ксанчх=Куплю м/м "Sanchez"[[курсор]]
ксанч=Куплю м/м "Sanchez"
квайц=Куплю м/м "Wayfarer" за $
квайхц=Куплю м/м "Wayfarer"[[курсор]] за $
квайх=Куплю м/м "Wayfarer"[[курсор]]
квай=Куплю м/м "Wayfarer"
кганц=Куплю макет любого оружия за $
кган=Куплю макет любого оружия
кганхц=Куплю макет оружия "[курсор]" за $
кганх=Куплю макет оружия "[курсор]"
как47ц=Куплю макет оружия "AK-47" за $
какац=Куплю макет оружия "AK-47" за $
как47=Куплю макет оружия "AK-47"
кака=Куплю макет оружия "AK-47"
квинтц=Куплю макет оружия "Country rifle" за $
крифц=Куплю макет оружия "Country rifle" за $
квинт=Куплю макет оружия "Country rifle"
криф=Куплю макет оружия "Country rifle"
кдиглц=Куплю макет оружия "Desert Eagle" за $
кдигл=Куплю макет оружия "Desert Eagle"
км4ц=Куплю макет оружия "M4" за $
кмкац=Куплю макет оружия "M4" за $
км4=Куплю макет оружия "M4"
кмка=Куплю макет оружия "M4"
кмп5ц=Куплю макет оружия "MP5" за $
кмп5=Куплю макет оружия "MP5"
кобрезц=Куплю макет оружия "Sawn-off shotgun" за $
кобрез=Куплю макет оружия "Sawn-off shotgun"
кдробц=Куплю макет оружия "Shotgun" за $
кдроб=Куплю макет оружия "Shotgun"
кглушц=Куплю макет оружия "Silenced pistol" за $
кглуш=Куплю макет оружия "Silenced pistol"
кдымц=Куплю макет оружия "Smoke Grenade" за $
кдым=Куплю макет оружия "Smoke Grenade"
ккемпц=Куплю макет оружия "Sniper rifle" за $
кснайпц=Куплю макет оружия "Sniper rifle" за $
ккемп=Куплю макет оружия "Sniper rifle"
кснайп=Куплю макет оружия "Sniper rifle"
кмц=Куплю мотоцикл любой марки за $
кмхц=Куплю мотоцикл любой марки[[курсор]] за $
кмх=Куплю мотоцикл любой марки[[курсор]]
км=Куплю мотоцикл любой марки
кд7орц=Куплю особняк 7-го класса в "Опасном районе" за $
кд7ор=Куплю особняк 7-го класса в "Опасном районе"
кд7вмфц=Куплю особняк 7-го класса в военном городке за $
кд7вмф=Куплю особняк 7-го класса в военном городке
кд7лвц=Куплю особняк 7-го класса в г. Лас-Вентурас за $
кд7лв=Куплю особняк 7-го класса в г. Лас-Вентурас
кд7лсц=Куплю особняк 7-го класса в г. Лос-Сантос за $
кд7лс=Куплю особняк 7-го класса в г. Лос-Сантос
кд7сфц=Куплю особняк 7-го класса в г. Сан-Фиерро за $
кд7сф=Куплю особняк 7-го класса в г. Сан-Фиерро
кд7прлвц=Куплю особняк 7-го класса в пригороде Лас-Вентураса за $
кд7прлв=Куплю особняк 7-го класса в пригороде Лас-Вентураса
кд7прлсц=Куплю особняк 7-го класса в пригороде Лос-Сантоса за $
кд7прлс=Куплю особняк 7-го класса в пригороде Лос-Сантоса
кд7прсфц=Куплю особняк 7-го класса в пригороде Сан-Фиерро за $
кд7прсф=Куплю особняк 7-го класса в пригороде Сан-Фиерро
кд7ввсц=Куплю особняк 7-го класса в пустыне за $
кд7свц=Куплю особняк 7-го класса в пустыне за $
кд7ввс=Куплю особняк 7-го класса в пустыне
кд7св=Куплю особняк 7-го класса в пустыне
кд7ппц=Куплю особняк 7-го класса в районе "Prickle Pine" за $
кд7пп=Куплю особняк 7-го класса в районе "Prickle Pine"
кд7ц=Куплю особняк 7-го класса за $
кд7ввц=Куплю особняк 7-го класса на горе "VineWood" за $
кд7вв=Куплю особняк 7-го класса на горе "VineWood"
кд7смц=Куплю особняк 7-го класса на пляже "Санта-Мария" за $
кд7см=Куплю особняк 7-го класса на пляже "Санта-Мария"
кд7=Куплю особняк 7-го класса
крепц=Куплю положительные отзывы за $
креп=Куплю положительные отзывы
кпопц=Куплю попугая за $
кпоп=Куплю попугая
ксемхц=Куплю свидетельство о регистрации семьи [курсор]-го поколения за $
ксемх=Куплю свидетельство о регистрации семьи [курсор]-го поколения
ксемц=Куплю свидетельство о регистрации семьи за $
ксем=Куплю свидетельство о регистрации семьи
ксц=Куплю сим-карту за $
ксхц=Куплю сим-карту с номером "[курсор]" за $
ксх=Куплю сим-карту с номером "[курсор]"
кс2ц=Куплю сим-карту формата "хх" за $
кс2=Куплю сим-карту формата "хх"
кс3ц=Куплю сим-карту формата "ххх" за $
кс3=Куплю сим-карту формата "ххх"
кс4ц=Куплю сим-карту формата "хххх" за $
кс4=Куплю сим-карту формата "хххх"
кс5ц=Куплю сим-карту формата "ххххх" за $
кс5=Куплю сим-карту формата "ххххх"
кс6ц=Куплю сим-карту формата "хххххх" за $
кс6=Куплю сим-карту формата "хххххх"
кс7ц=Куплю сим-карту формата "ххххххх" за $
кс7=Куплю сим-карту формата "ххххххх"
кс=Куплю сим-карту
кдржц=Куплю строительные материалы за $
кждрц=Куплю строительные материалы за $
кстрц=Куплю строительные материалы за $
кдрж=Куплю строительные материалы
кждр=Куплю строительные материалы
кстр=Куплю строительные материалы
скидка=Магазин 24/7 "[курсор]" дарит скидку в размере ‰
пжинтимц=Предоставляю интимные услуги за $
пжинтц=Предоставляю интимные услуги за $
пинтимц=Предоставляю интимные услуги за $
пжинт=Предоставляю интимные услуги
пжинтим=Предоставляю интимные услуги
пинтим=Предоставляю интимные услуги
пмехц=Предоставляю услуги автомеханика за $
пмех=Предоставляю услуги автомеханика
падвоклв=Предоставляю услуги адвоката в г. Лас-Вентурас
падвоклс=Предоставляю услуги адвоката в г. Лос-Сантос
падвоксф=Предоставляю услуги адвоката в г. Сан-Фиерро
падвок=Предоставляю услуги адвоката
пгрузц=Предоставляю услуги грузоперевозчика за $
пгруз=Предоставляю услуги грузоперевозчика
пжнчц=Предоставляю услуги домработницы за $
пжнч=Предоставляю услуги домработницы
пцветыц=Предоставляю услуги доставщика цветов за $
пцветы=Предоставляю услуги доставщика цветов
плицлв=Предоставляю услуги лицензера в г. Лас-Вентурас
плицлс=Предоставляю услуги лицензера в г. Лос-Сантос
плицсф=Предоставляю услуги лицензера в г. Сан-Фиерро
плиц=Предоставляю услуги лицензера
пкрупье=Предоставляю услуги личного крупье
пмнчц=Предоставляю услуги мужа на час за $
пмнч=Предоставляю услуги мужа на час
пстрипц=Предоставляю услуги приватных танцев за $
пстрип=Предоставляю услуги приватных танцев
пмани=Предоставляю финансовые услуги в размере до $
рмаст=Приглашаем вас в автомастерскую "[курсор]"
ркомф=Приглашаем вас в автосалон комфорт "[курсор]" в г. Сан-Фиерро
ркомфорт=Приглашаем вас в автосалон комфорт "[курсор]" в г. Сан-Фиерро
рэко=Приглашаем вас в автосалон эконом "[курсор]" в г. Лос-Сантос
рэконом=Приглашаем вас в автосалон эконом "[курсор]" в г. Лос-Сантос
рпоч=Приглашаем вас в автосервис "[курсор]"
рвело=Приглашаем вас в велосалон "[курсор]" в г. Лос-Сантос
рмото=Приглашаем вас в мотосалон "[курсор]" в г. Сан-Фиерро
рриелтор=Приглашаем вас в наше риэлторское агенство "[курсор]" в г. Лас-Вентурас
рагент=Приглашаем вас в наше риэлторское агенство "[курсор]"
рэлит=Приглашаем вас в элитный автосалон "[курсор]" в г. Лас-Вентурас
рэлитный=Приглашаем вас в элитный автосалон "[курсор]" в г. Лас-Вентурас
разс=Приглашаем вас заправиться на АЗС "[курсор]"
р247=Приглашаем вас купить товар в магазине "[курсор]" 
рмаг=Приглашаем вас купить товар в магазине "[курсор]" 
ракс=Приглашаем вас купить товар в магазине аксессуаров "[курсор]"
рпетарды=Приглашаем вас купить товар в магазине пиротехники "[курсор]" в г. Лос-Сантос
рсалют=Приглашаем вас купить товар в магазине пиротехники "[курсор]" в г. Лос-Сантос
рпиро=Приглашаем вас купить товар в магазине пиротехники "[курсор]"
рган=Приглашаем вас купить товар в оружейном магазине "[курсор]"
роруж=Приглашаем вас купить товар в оружейном магазине "[курсор]"
ррыб=Приглашаем вас купить товар в рыболовном магазине "[курсор]"
рсиг=Приглашаем вас купить товар в табачном магазине "[курсор]"
ртабак=Приглашаем вас купить товар в табачном магазине "[курсор]"
реда=Приглашаем вас перекусить в закусочную "[курсор]" 
рзак=Приглашаем вас перекусить в закусочную "[курсор]" 
рбар=Приглашаем вас посетить бар "[курсор]"
ркор=Приглашаем вас посетить корабль "[курсор]" в г. Сан-Фиерро
ригрушки=Приглашаем вас посетить магазин воздушных RC игрушек "[курсор]" в пустыне
ррс=Приглашаем вас посетить магазин воздушных RC игрушек "[курсор]"
рпарик=Приглашаем вас посетить парикмахерскую "[курсор]"
рпен=Приглашаем вас развлечься на аттракционе "Пенек" в пригороде Лос-Сантоса
рджет=Приглашаем вас развлечься на аттракционе джетпаков "[курсор]"
рпарашют=Приглашаем вас развлечься на прыжках с парашюта "[курсор]" в г. Лос-Сантос
пати=Приглашаем всех посетить вечеринку в доме №
пати=Приглашаем всех посетить вечеринку в доме №
патиджиззи=Приглашаем всех посетить вечеринку в клубе "Jizzy"
трен=Провожу тренировки в любом спортзале штата
тренлв=Провожу тренировки в спортзале г. Лас-Вентурас
тренлс=Провожу тренировки в спортзале г. Лос-Сантос
тренсф=Провожу тренировки в спортзале г. Сан-Фиерро
пкгдрц=Продам [курсор] кг дерева за $
пкгдц=Продам [курсор] кг дерева за $
пхдрц=Продам [курсор] кг дерева за $
пкгд=Продам [курсор] кг дерева
пкгдр=Продам [курсор] кг дерева
пхдр=Продам [курсор] кг дерева
пкгжц=Продам [курсор] кг железа за $
пхжц=Продам [курсор] кг железа за $
пкгж=Продам [курсор] кг железа
пхж=Продам [курсор] кг железа
пкгдржц=Продам [курсор] кг строительных материалов за $
пкгждрц=Продам [курсор] кг строительных материалов за $
пхстрц=Продам [курсор] кг строительных материалов за $
пкгдрж=Продам [курсор] кг строительных материалов
пкгждр=Продам [курсор] кг строительных материалов
пхстр=Продам [курсор] кг строительных материалов
пхрепц=Продам [курсор] положительных отзывов за $
пхреп=Продам [курсор] положительных отзывов
п1репц=Продам [курсор]1 положительный отзыв за $
п1реп=Продам [курсор]1 положительный отзыв
п2репц=Продам [курсор]2 положительных отзыва за $
п2реп=Продам [курсор]2 положительных отзыва
п3репц=Продам [курсор]3 положительных отзыва за $
п3реп=Продам [курсор]3 положительных отзыва
п4репц=Продам [курсор]4 положительных отзыва за $
п4реп=Продам [курсор]4 положительных отзыва
памц=Продам а/м "[курсор]" за $
памхц=Продам а/м "[курсор]"[] за $
памх=Продам а/м "[курсор]"[]
пам=Продам а/м "[курсор]"
пакурац=Продам а/м "Acura" за $
пакурахц=Продам а/м "Acura"[[курсор]] за $
пакурах=Продам а/м "Acura"[[курсор]]
пакура=Продам а/м "Acura"
падмц=Продам а/м "Admiral" за $
падмхц=Продам а/м "Admiral"[[курсор]] за $
падмх=Продам а/м "Admiral"[[курсор]]
падм=Продам а/м "Admiral"
пальц=Продам а/м "Alpha" за $
пальхц=Продам а/м "Alpha"[[курсор]] за $
пальх=Продам а/м "Alpha"[[курсор]]
паль=Продам а/м "Alpha"
пастонц=Продам а/м "Aston Martin DB11" за $
пастонхц=Продам а/м "Aston Martin DB11"[[курсор]] за $
пастонх=Продам а/м "Aston Martin DB11"[[курсор]]
пастон=Продам а/м "Aston Martin DB11"
паудикц=Продам а/м "Audi Q8R" за $
паудикхц=Продам а/м "Audi Q8R"[[курсор]] за $
паудикх=Продам а/м "Audi Q8R"[[курсор]]
паудик=Продам а/м "Audi Q8R"
паудирц=Продам а/м "Audi R8" за $
паудирхц=Продам а/м "Audi R8"[[курсор]] за $
паудирх=Продам а/м "Audi R8"[[курсор]]
паудир=Продам а/м "Audi R8"
пбагц=Продам а/м "Baggage" за $
пбагхц=Продам а/м "Baggage"[[курсор]] за $
пбагх=Продам а/м "Baggage"[[курсор]]
пбаг=Продам а/м "Baggage"
пбандц=Продам а/м "Bandito" за $
пбандхц=Продам а/м "Bandito"[[курсор]] за $
пбандх=Продам а/м "Bandito"[[курсор]]
пбанд=Продам а/м "Bandito"
пбаншц=Продам а/м "Banshee" за $
пбаншхц=Продам а/м "Banshee"[[курсор]] за $
пбаншх=Продам а/м "Banshee"[[курсор]]
пбанш=Продам а/м "Banshee"
пбаракц=Продам а/м "Barracks" за $
пбаракхц=Продам а/м "Barracks"[[курсор]] за $
пбаракх=Продам а/м "Barracks"[[курсор]]
пбарак=Продам а/м "Barracks"
пбфиц=Продам а/м "BF Injection" за $
пбфихц=Продам а/м "BF Injection"[[курсор]] за $
пбфих=Продам а/м "BF Injection"[[курсор]]
пбфи=Продам а/м "BF Injection"
пблец=Продам а/м "Blade" за $
пблехц=Продам а/м "Blade"[[курсор]] за $
пблех=Продам а/м "Blade"[[курсор]]
пбле=Продам а/м "Blade"
пблихц=Продам а/м "Blista Сompact"[[курсор]] за $
пблих=Продам а/м "Blista Сompact"[[курсор]]
пбли=Продам а/м "Blista Сompact"
пблиц=Продам а/м "Blista Compact" за $
пблац=Продам а/м "Bloodring Banger" за $
пблуц=Продам а/м "Bloodring Banger" за $
пблахц=Продам а/м "Bloodring Banger"[[курсор]] за $
пблухц=Продам а/м "Bloodring Banger"[[курсор]] за $
пблах=Продам а/м "Bloodring Banger"[[курсор]]
пблух=Продам а/м "Bloodring Banger"[[курсор]]
пбла=Продам а/м "Bloodring Banger"
пблу=Продам а/м "Bloodring Banger"
пбмв2ц=Продам а/м "BMW M2 F87" за $
пбмв2хц=Продам а/м "BMW M2 F87"[[курсор]] за $
пбмв2х=Продам а/м "BMW M2 F87"[[курсор]]
пбмв2=Продам а/м "BMW M2 F87"
пбмв3ц=Продам а/м "BMW M3 E46" за $
пбмв3хц=Продам а/м "BMW M3 E46"[[курсор]] за $
пбмв3х=Продам а/м "BMW M3 E46"[[курсор]]
пбмв3=Продам а/м "BMW M3 E46"
пбрац=Продам а/м "Bravura" за $
пбрахц=Продам а/м "Bravura"[[курсор]] за $
пбрах=Продам а/м "Bravura"[[курсор]]
пбра=Продам а/м "Bravura"
пброц=Продам а/м "Broadway" за $
пброхц=Продам а/м "Broadway"[[курсор]] за $
пброх=Продам а/м "Broadway"[[курсор]]
пбро=Продам а/м "Broadway"
пбукц=Продам а/м "Buccaneer" за $
пбукхц=Продам а/м "Buccaneer"[[курсор]] за $
пбукх=Продам а/м "Buccaneer"[[курсор]]
пбук=Продам а/м "Buccaneer"
пбуфц=Продам а/м "Buffalo" за $
пбуфхц=Продам а/м "Buffalo"[[курсор]] за $
пбуфх=Продам а/м "Buffalo"[[курсор]]
пбуф=Продам а/м "Buffalo"
пбалц=Продам а/м "Bullet" за $
пбулц=Продам а/м "Bullet" за $
пбалхц=Продам а/м "Bullet"[[курсор]] за $
пбулхц=Продам а/м "Bullet"[[курсор]] за $
пбалх=Продам а/м "Bullet"[[курсор]]
пбулх=Продам а/м "Bullet"[[курсор]]
пбал=Продам а/м "Bullet"
пбул=Продам а/м "Bullet"
пбурц=Продам а/м "Burrito" за $
пбурхц=Продам а/м "Burrito"[[курсор]] за $
пбурх=Продам а/м "Burrito"[[курсор]]
пбур=Продам а/м "Burrito"
пкадиц=Продам а/м "Caddy" за $
пкадихц=Продам а/м "Caddy"[[курсор]] за $
пкадих=Продам а/м "Caddy"[[курсор]]
пкади=Продам а/м "Caddy"
пкадилц=Продам а/м "Cadillac XT6" за $
пкадилхц=Продам а/м "Cadillac XT6"[[курсор]] за $
пкадилх=Продам а/м "Cadillac XT6"[[курсор]]
пкадил=Продам а/м "Cadillac XT6"
пкадрц=Продам а/м "Cadrona" за $
пкадрхц=Продам а/м "Cadrona"[[курсор]] за $
пкадрх=Продам а/м "Cadrona"[[курсор]]
пкадр=Продам а/м "Cadrona"
пкамц=Продам а/м "Camper" за $
пкамхц=Продам а/м "Camper"[[курсор]] за $
пкамх=Продам а/м "Camper"[[курсор]]
пкам=Продам а/м "Camper"
пчитц=Продам а/м "Cheetah" за $
пчитхц=Продам а/м "Cheetah"[[курсор]] за $
пчитх=Продам а/м "Cheetah"[[курсор]]
пчит=Продам а/м "Cheetah"
пкамароц=Продам а/м "Chevrolet Camaro" за $
пкамарохц=Продам а/м "Chevrolet Camaro"[[курсор]] за $
пкамарох=Продам а/м "Chevrolet Camaro"[[курсор]]
пкамаро=Продам а/м "Chevrolet Camaro"
пкапризц=Продам а/м "Chevrolet Caprice" за $
пкапризхц=Продам а/м "Chevrolet Caprice"[[курсор]] за $
пкапризх=Продам а/м "Chevrolet Caprice"[[курсор]]
пкаприз=Продам а/м "Chevrolet Caprice"
пкорветц=Продам а/м "Chevrolet Corvette C6" за $
пкорветхц=Продам а/м "Chevrolet Corvette C6"[[курсор]] за $
пкорветх=Продам а/м "Chevrolet Corvette C6"[[курсор]]
пкорвет=Продам а/м "Chevrolet Corvette C6"
пимпалац=Продам а/м "Chevrolet Impala 2018" за $
пимпалахц=Продам а/м "Chevrolet Impala 2018"[[курсор]] за $
пимпалах=Продам а/м "Chevrolet Impala 2018"[[курсор]]
пимпала=Продам а/м "Chevrolet Impala 2018"
птахоец=Продам а/м "Chevrolet Tahoe" за $
птахоехц=Продам а/м "Chevrolet Tahoe"[[курсор]] за $
птахоех=Продам а/м "Chevrolet Tahoe"[[курсор]]
птахое=Продам а/м "Chevrolet Tahoe"
пклоц=Продам а/м "Clover" за $
пклохц=Продам а/м "Clover"[[курсор]] за $
пклох=Продам а/м "Clover"[[курсор]]
пкло=Продам а/м "Clover"
пклац=Продам а/м "Club" за $
пклахц=Продам а/м "Club"[[курсор]] за $
пклах=Продам а/м "Club"[[курсор]]
пкла=Продам а/м "Club"
пкоачц=Продам а/м "Coach" за $
пкоачхц=Продам а/м "Coach"[[курсор]] за $
пкоачх=Продам а/м "Coach"[[курсор]]
пкоач=Продам а/м "Coach"
пкомц=Продам а/м "Comet" за $
пкомхц=Продам а/м "Comet"[[курсор]] за $
пкомх=Продам а/м "Comet"[[курсор]]
пком=Продам а/м "Comet"
пчарджртц=Продам а/м "Dodge Charger R/T" за $
пчарджртхц=Продам а/м "Dodge Charger R/T"[[курсор]] за $
пчарджртх=Продам а/м "Dodge Charger R/T"[[курсор]]
пчарджрт=Продам а/м "Dodge Charger R/T"
пчарджц=Продам а/м "Dodge Charger" за $
пчарджхц=Продам а/м "Dodge Charger"[[курсор]] за $
пчарджх=Продам а/м "Dodge Charger"[[курсор]]
пчардж=Продам а/м "Dodge Charger"
пдозерц=Продам а/м "Dozer" за $
пдозерхц=Продам а/м "Dozer"[[курсор]] за $
пдозерх=Продам а/м "Dozer"[[курсор]]
пдозер=Продам а/м "Dozer"
пдамперц=Продам а/м "Dumper" за $
пдамперхц=Продам а/м "Dumper"[[курсор]] за $
пдамперх=Продам а/м "Dumper"[[курсор]]
пдампер=Продам а/м "Dumper"
пдюнц=Продам а/м "Duneride" за $
пдюнхц=Продам а/м "Duneride"[[курсор]] за $
пдюнх=Продам а/м "Duneride"[[курсор]]
пдюн=Продам а/м "Duneride"
пелегац=Продам а/м "Elegant" за $
пелегахц=Продам а/м "Elegant"[[курсор]] за $
пелегах=Продам а/м "Elegant"[[курсор]]
пелега=Продам а/м "Elegant"
пелегиц=Продам а/м "Elegy" за $
пелегихц=Продам а/м "Elegy"[[курсор]] за $
пелегих=Продам а/м "Elegy"[[курсор]]
пелеги=Продам а/м "Elegy"
пимпц=Продам а/м "Emperor" за $
пимпхц=Продам а/м "Emperor"[[курсор]] за $
пимпх=Продам а/м "Emperor"[[курсор]]
пимп=Продам а/м "Emperor"
пенфорц=Продам а/м "Enforcer" за $
пенфорхц=Продам а/м "Enforcer"[[курсор]] за $
пенфорх=Продам а/м "Enforcer"[[курсор]]
пенфор=Продам а/м "Enforcer"
песпц=Продам а/м "Esperanto" за $
песпхц=Продам а/м "Esperanto"[[курсор]] за $
песпх=Продам а/м "Esperanto"[[курсор]]
песп=Продам а/м "Esperanto"
певрц=Продам а/м "Euros" за $
певрхц=Продам а/м "Euros"[[курсор]] за $
певрх=Продам а/м "Euros"[[курсор]]
певр=Продам а/м "Euros"
пфбирц=Продам а/м "FBI Rancher" за $
пфбирхц=Продам а/м "FBI Rancher"[[курсор]] за $
пфбирх=Продам а/м "FBI Rancher"[[курсор]]
пфбир=Продам а/м "FBI Rancher"
пфбитц=Продам а/м "FBI Truck" за $
пфбитхц=Продам а/м "FBI Truck"[[курсор]] за $
пфбитх=Продам а/м "FBI Truck"[[курсор]]
пфбит=Продам а/м "FBI Truck"
пфелц=Продам а/м "Feltzer" за $
пфелхц=Продам а/м "Feltzer"[[курсор]] за $
пфелх=Продам а/м "Feltzer"[[курсор]]
пфел=Продам а/м "Feltzer"
пферц=Продам а/м "Ferrari 488 GTB" за $
пферхц=Продам а/м "Ferrari 488 GTB"[[курсор]] за $
пферх=Продам а/м "Ferrari 488 GTB"[[курсор]]
пфер=Продам а/м "Ferrari 488 GTB"
пфайрц=Продам а/м "Firetruck" за $
пфайрхц=Продам а/м "Firetruck"[[курсор]] за $
пфайрх=Продам а/м "Firetruck"[[курсор]]
пфайр=Продам а/м "Firetruck"
пфлец=Продам а/м "Flash" за $
пфлехц=Продам а/м "Flash"[[курсор]] за $
пфлех=Продам а/м "Flash"[[курсор]]
пфле=Продам а/м "Flash"
пвикторияц=Продам а/м "Ford Crown Victoria" за $
пвикторияхц=Продам а/м "Ford Crown Victoria"[[курсор]] за $
пвикториях=Продам а/м "Ford Crown Victoria"[[курсор]]
пвиктория=Продам а/м "Ford Crown Victoria"
пексплц=Продам а/м "Ford Explorer" за $
пексплхц=Продам а/м "Ford Explorer"[[курсор]] за $
пексплх=Продам а/м "Ford Explorer"[[курсор]]
пекспл=Продам а/м "Ford Explorer"
пмустангц=Продам а/м "Ford Shelby Mustang" за $
пмустангхц=Продам а/м "Ford Shelby Mustang"[[курсор]] за $
пмустангх=Продам а/м "Ford Shelby Mustang"[[курсор]]
пмустанг=Продам а/м "Ford Shelby Mustang"
птаурусц=Продам а/м "Ford Taurus" за $
птаурусхц=Продам а/м "Ford Taurus"[[курсор]] за $
птаурусх=Продам а/м "Ford Taurus"[[курсор]]
птаурус=Продам а/м "Ford Taurus"
пфорц=Продам а/м "Fortune" за $
пфорхц=Продам а/м "Fortune"[[курсор]] за $
пфорх=Продам а/м "Fortune"[[курсор]]
пфор=Продам а/м "Fortune"
пглендалшц=Продам а/м "Glendale Shit" за $
пглендалшхц=Продам а/м "Glendale Shit"[[курсор]] за $
пглендалшх=Продам а/м "Glendale Shit"[[курсор]]
пглендалш=Продам а/м "Glendale Shit"
пглец=Продам а/м "Glendale" за $
пглехц=Продам а/м "Glendale"[[курсор]] за $
пглех=Продам а/м "Glendale"[[курсор]]
пгле=Продам а/м "Glendale"
пгриц=Продам а/м "Greenwood" за $
пгрихц=Продам а/м "Greenwood"[[курсор]] за $
пгрих=Продам а/м "Greenwood"[[курсор]]
пгри=Продам а/м "Greenwood"
пгерц=Продам а/м "Hermes" за $
пгерхц=Продам а/м "Hermes"[[курсор]] за $
пгерх=Продам а/м "Hermes"[[курсор]]
пгер=Продам а/м "Hermes"
псивикц=Продам а/м "Honda Civic Gen 3" за $
псивикхц=Продам а/м "Honda Civic Gen 3"[[курсор]] за $
псивикх=Продам а/м "Honda Civic Gen 3"[[курсор]]
псивик=Продам а/м "Honda Civic Gen 3"
пхотнц=Продам а/м "Hotknife" за $
пхотнхц=Продам а/м "Hotknife"[[курсор]] за $
пхотнх=Продам а/м "Hotknife"[[курсор]]
пхотн=Продам а/м "Hotknife"
пхотац=Продам а/м "Hotring Racer A" за $
пхотахц=Продам а/м "Hotring Racer A"[[курсор]] за $
пхотах=Продам а/м "Hotring Racer A"[[курсор]]
пхота=Продам а/м "Hotring Racer A"
пхотбц=Продам а/м "Hotring Racer B" за $
пхотбхц=Продам а/м "Hotring Racer B"[[курсор]] за $
пхотбх=Продам а/м "Hotring Racer B"[[курсор]]
пхотб=Продам а/м "Hotring Racer B"
пхотц=Продам а/м "Hotring Racer" за $
пхотхц=Продам а/м "Hotring Racer"[[курсор]] за $
пхотх=Продам а/м "Hotring Racer"[[курсор]]
пхот=Продам а/м "Hotring Racer"
пхамц=Продам а/м "Hummer H2" за $
пхамхц=Продам а/м "Hummer H2"[[курсор]] за $
пхамх=Продам а/м "Hummer H2"[[курсор]]
пхам=Продам а/м "Hummer H2"
пханц=Продам а/м "Huntley" за $
пханхц=Продам а/м "Huntley"[[курсор]] за $
пханх=Продам а/м "Huntley"[[курсор]]
пхан=Продам а/м "Huntley"
пхасц=Продам а/м "Hustler" за $
пхасхц=Продам а/м "Hustler"[[курсор]] за $
пхасх=Продам а/м "Hustler"[[курсор]]
пхас=Продам а/м "Hustler"
пинфц=Продам а/м "Infernus" за $
пинфхц=Продам а/м "Infernus"[[курсор]] за $
пинфх=Продам а/м "Infernus"[[курсор]]
пинф=Продам а/м "Infernus"
пинфинц=Продам а/м "Infinity FX35" за $
пинфинхц=Продам а/м "Infinity FX35"[[курсор]] за $
пинфинх=Продам а/м "Infinity FX35"[[курсор]]
пинфин=Продам а/м "Infinity FX35"
пинтц=Продам а/м "Intruder" за $
пинтхц=Продам а/м "Intruder"[[курсор]] за $
пинтх=Продам а/м "Intruder"[[курсор]]
пинт=Продам а/м "Intruder"
пчирокиц=Продам а/м "Jeep Cherokee SRT WK1" за $
пчирокихц=Продам а/м "Jeep Cherokee SRT WK1"[[курсор]] за $
пчироких=Продам а/м "Jeep Cherokee SRT WK1"[[курсор]]
пчироки=Продам а/м "Jeep Cherokee SRT WK1"
пджц=Продам а/м "Jester" за $
пджхц=Продам а/м "Jester"[[курсор]] за $
пджх=Продам а/м "Jester"[[курсор]]
пдж=Продам а/м "Jester"
пджуц=Продам а/м "Journey" за $
пджухц=Продам а/м "Journey"[[курсор]] за $
пджух=Продам а/м "Journey"[[курсор]]
пджу=Продам а/м "Journey"
пкарц=Продам а/м "Kart" за $
пкархц=Продам а/м "Kart"[[курсор]] за $
пкарх=Продам а/м "Kart"[[курсор]]
пкар=Продам а/м "Kart"
п2107ц=Продам а/м "Lada 2107" за $
п2107хц=Продам а/м "Lada 2107"[[курсор]] за $
п2107х=Продам а/м "Lada 2107"[[курсор]]
п2107=Продам а/м "Lada 2107"
пприорац=Продам а/м "Lada Priora" за $
пприорахц=Продам а/м "Lada Priora"[[курсор]] за $
пприорах=Продам а/м "Lada Priora"[[курсор]]
пприора=Продам а/м "Lada Priora"
пламбц=Продам а/м "Lamborghini Gallardo" за $
пламбхц=Продам а/м "Lamborghini Gallardo"[[курсор]] за $
пламбх=Продам а/м "Lamborghini Gallardo"[[курсор]]
пламб=Продам а/м "Lamborghini Gallardo"
планц=Продам а/м "Landstalker" за $
планхц=Продам а/м "Landstalker"[[курсор]] за $
планх=Продам а/м "Landstalker"[[курсор]]
план=Продам а/м "Landstalker"
плекс3ц=Продам а/м "Lexus IS300" за $
плекс3хц=Продам а/м "Lexus IS300"[[курсор]] за $
плекс3х=Продам а/м "Lexus IS300"[[курсор]]
плекс3=Продам а/м "Lexus IS300"
плекс5ц=Продам а/м "Lexus LS500" за $
плекс5хц=Продам а/м "Lexus LS500"[[курсор]] за $
плекс5х=Продам а/м "Lexus LS500"[[курсор]]
плекс5=Продам а/м "Lexus LS500"
плайнерц=Продам а/м "Linerunner" за $
плайнерхц=Продам а/м "Linerunner"[[курсор]] за $
плайнерх=Продам а/м "Linerunner"[[курсор]]
плайнер=Продам а/м "Linerunner"
плвпдц=Продам а/м "LVPD Police Car" за $
плвпдхц=Продам а/м "LVPD Police Car"[[курсор]] за $
плвпдх=Продам а/м "LVPD Police Car"[[курсор]]
плвпд=Продам а/м "LVPD Police Car"
пмажц=Продам а/м "Majestic" за $
пмажхц=Продам а/м "Majestic"[[курсор]] за $
пмажх=Продам а/м "Majestic"[[курсор]]
пмаж=Продам а/м "Majestic"
пманц=Продам а/м "Manana" за $
пманхц=Продам а/м "Manana"[[курсор]] за $
пманх=Продам а/м "Manana"[[курсор]]
пман=Продам а/м "Manana"
пмерс190ц=Продам а/м "Mercedes Benz 190E II" за $
пмерс190хц=Продам а/м "Mercedes Benz 190E II"[[курсор]] за $
пмерс190х=Продам а/м "Mercedes Benz 190E II"[[курсор]]
пмерс190=Продам а/м "Mercedes Benz 190E II"
пмерсец=Продам а/м "Mercedes Benz E-Class" за $
пмерсехц=Продам а/м "Mercedes Benz E-Class"[[курсор]] за $
пмерсех=Продам а/м "Mercedes Benz E-Class"[[курсор]]
пмерсе=Продам а/м "Mercedes Benz E-Class"
пмерсгц=Продам а/м "Mercedes Benz G-Class" за $
пмерсгхц=Продам а/м "Mercedes Benz G-Class"[[курсор]] за $
пмерсгх=Продам а/м "Mercedes Benz G-Class"[[курсор]]
пмерсг=Продам а/м "Mercedes Benz G-Class"
пмерсслц=Продам а/м "Mercedes Benz SL65" за $
пмерсслхц=Продам а/м "Mercedes Benz SL65"[[курсор]] за $
пмерсслх=Продам а/м "Mercedes Benz SL65"[[курсор]]
пмерссл=Продам а/м "Mercedes Benz SL65"
пмерсамгц=Продам а/м "Mercedes Benz SLS AMG" за $
пмерсамгхц=Продам а/м "Mercedes Benz SLS AMG"[[курсор]] за $
пмерсамгх=Продам а/м "Mercedes Benz SLS AMG"[[курсор]]
пмерсамг=Продам а/м "Mercedes Benz SLS AMG"
пмерс124ц=Продам а/м "Mercedes Benz W124" за $
пмерс124хц=Продам а/м "Mercedes Benz W124"[[курсор]] за $
пмерс124х=Продам а/м "Mercedes Benz W124"[[курсор]]
пмерс124=Продам а/м "Mercedes Benz W124"
пмерсрц=Продам а/м "Mercedes R129" за $
пмерсрхц=Продам а/м "Mercedes R129"[[курсор]] за $
пмерсрх=Продам а/м "Mercedes R129"[[курсор]]
пмерср=Продам а/м "Mercedes R129"
пмерц=Продам а/м "Merit" за $
пмерхц=Продам а/м "Merit"[[курсор]] за $
пмерх=Продам а/м "Merit"[[курсор]]
пмер=Продам а/м "Merit"
пмесц=Продам а/м "Mesa" за $
пмесхц=Продам а/м "Mesa"[[курсор]] за $
пмесх=Продам а/м "Mesa"[[курсор]]
пмес=Продам а/м "Mesa"
пмитсубц=Продам а/м "Mitsubishi 3000GT" за $
пмитсубхц=Продам а/м "Mitsubishi 3000GT"[[курсор]] за $
пмитсубх=Продам а/м "Mitsubishi 3000GT"[[курсор]]
пмитсуб=Продам а/м "Mitsubishi 3000GT"
планс9ц=Продам а/м "Mitsubishi Lancer Evo IX" за $
планс9хц=Продам а/м "Mitsubishi Lancer Evo IX"[[курсор]] за $
планс9х=Продам а/м "Mitsubishi Lancer Evo IX"[[курсор]]
планс9=Продам а/м "Mitsubishi Lancer Evo IX"
планс10ц=Продам а/м "Mitsubishi Lancer Evo X" за $
планс10хц=Продам а/м "Mitsubishi Lancer Evo X"[[курсор]] за $
планс10х=Продам а/м "Mitsubishi Lancer Evo X"[[курсор]]
планс10=Продам а/м "Mitsubishi Lancer Evo X"
пмонац=Продам а/м "Monster Truck A" за $
пмонахц=Продам а/м "Monster Truck A"[[курсор]] за $
пмонах=Продам а/м "Monster Truck A"[[курсор]]
пмона=Продам а/м "Monster Truck A"
пмонбц=Продам а/м "Monster Truck B" за $
пмонбхц=Продам а/м "Monster Truck B"[[курсор]] за $
пмонбх=Продам а/м "Monster Truck B"[[курсор]]
пмонб=Продам а/м "Monster Truck B"
пмонц=Продам а/м "Monster Truck" за $
пмонхц=Продам а/м "Monster Truck"[[курсор]] за $
пмонх=Продам а/м "Monster Truck"[[курсор]]
пмон=Продам а/м "Monster Truck"
пмунц=Продам а/м "Moonbeam" за $
пмунхц=Продам а/м "Moonbeam"[[курсор]] за $
пмунх=Продам а/м "Moonbeam"[[курсор]]
пмун=Продам а/м "Moonbeam"
пмовц=Продам а/м "Mower" за $
пмовхц=Продам а/м "Mower"[[курсор]] за $
пмовх=Продам а/м "Mower"[[курсор]]
пмов=Продам а/м "Mower"
пнебц=Продам а/м "Nebula" за $
пнебхц=Продам а/м "Nebula"[[курсор]] за $
пнебх=Продам а/м "Nebula"[[курсор]]
пнеб=Продам а/м "Nebula"
покец=Продам а/м "Oceanic" за $
покехц=Продам а/м "Oceanic"[[курсор]] за $
покех=Продам а/м "Oceanic"[[курсор]]
поке=Продам а/м "Oceanic"
ппатрц=Продам а/м "Patriot" за $
ппатрхц=Продам а/м "Patriot"[[курсор]] за $
ппатрх=Продам а/м "Patriot"[[курсор]]
ппатр=Продам а/м "Patriot"
пперц=Продам а/м "Perennial" за $
пперхц=Продам а/м "Perennial"[[курсор]] за $
пперх=Продам а/м "Perennial"[[курсор]]
ппер=Продам а/м "Perennial"
пфенц=Продам а/м "Phoenix" за $
пфоец=Продам а/м "Phoenix" за $
пфенхц=Продам а/м "Phoenix"[[курсор]] за $
пфоехц=Продам а/м "Phoenix"[[курсор]] за $
пфенх=Продам а/м "Phoenix"[[курсор]]
пфоех=Продам а/м "Phoenix"[[курсор]]
пфен=Продам а/м "Phoenix"
пфое=Продам а/м "Phoenix"
прангерц=Продам а/м "Police Ranger" за $
прангерхц=Продам а/м "Police Ranger"[[курсор]] за $
прангерх=Продам а/м "Police Ranger"[[курсор]]
прангер=Продам а/м "Police Ranger"
ппоршц=Продам а/м "Porsche 911 GT2" за $
ппоршхц=Продам а/м "Porsche 911 GT2"[[курсор]] за $
ппоршх=Продам а/м "Porsche 911 GT2"[[курсор]]
ппорш=Продам а/м "Porsche 911 GT2"
ппрец=Продам а/м "Premier" за $
ппрехц=Продам а/м "Premier"[[курсор]] за $
ппрех=Продам а/м "Premier"[[курсор]]
ппре=Продам а/м "Premier"
ппревц=Продам а/м "Previon" за $
ппревхц=Продам а/м "Previon"[[курсор]] за $
ппревх=Продам а/м "Previon"[[курсор]]
ппрев=Продам а/м "Previon"
пприц=Продам а/м "Primo" за $
пприхц=Продам а/м "Primo"[[курсор]] за $
пприх=Продам а/м "Primo"[[курсор]]
ппри=Продам а/м "Primo"
пранц=Продам а/м "Rancher" за $
пранхц=Продам а/м "Rancher"[[курсор]] за $
пранх=Продам а/м "Rancher"[[курсор]]
пран=Продам а/м "Rancher"
проверц=Продам а/м "Range Rover" за $
проверхц=Продам а/м "Range Rover"[[курсор]] за $
проверх=Продам а/м "Range Rover"[[курсор]]
провер=Продам а/м "Range Rover"
прегц=Продам а/м "Regina" за $
прегхц=Продам а/м "Regina"[[курсор]] за $
прегх=Продам а/м "Regina"[[курсор]]
прег=Продам а/м "Regina"
премц=Продам а/м "Remington" за $
премхц=Продам а/м "Remington"[[курсор]] за $
премх=Продам а/м "Remington"[[курсор]]
прем=Продам а/м "Remington"
проллсц=Продам а/м "Rolls-Royce Phantom 7" за $
проллсхц=Продам а/м "Rolls-Royce Phantom 7"[[курсор]] за $
проллсх=Продам а/м "Rolls-Royce Phantom 7"[[курсор]]
проллс=Продам а/м "Rolls-Royce Phantom 7"
промц=Продам а/м "Romero" за $
промхц=Продам а/м "Romero"[[курсор]] за $
промх=Продам а/м "Romero"[[курсор]]
пром=Продам а/м "Romero"
псватц=Продам а/м "S.W.A.T Van" за $
псватхц=Продам а/м "S.W.A.T Van"[[курсор]] за $
псватх=Продам а/м "S.W.A.T Van"[[курсор]]
псват=Продам а/м "S.W.A.T Van"
псабц=Продам а/м "Sabre" за $
псабхц=Продам а/м "Sabre"[[курсор]] за $
псабх=Продам а/м "Sabre"[[курсор]]
псаб=Продам а/м "Sabre"
псандц=Продам а/м "Sandking" за $
псандхц=Продам а/м "Sandking"[[курсор]] за $
псандх=Продам а/м "Sandking"[[курсор]]
псанд=Продам а/м "Sandking"
псавц=Продам а/м "Savanna" за $
псавхц=Продам а/м "Savanna"[[курсор]] за $
псавх=Продам а/м "Savanna"[[курсор]]
псав=Продам а/м "Savanna"
псенц=Продам а/м "Sentinel" за $
псенхц=Продам а/м "Sentinel"[[курсор]] за $
псенх=Продам а/м "Sentinel"[[курсор]]
псен=Продам а/м "Sentinel"
псфпдц=Продам а/м "SFPD Police Car" за $
псфпдхц=Продам а/м "SFPD Police Car"[[курсор]] за $
псфпдх=Продам а/м "SFPD Police Car"[[курсор]]
псфпд=Продам а/м "SFPD Police Car"
пслац=Продам а/м "Slamvan" за $
пслахц=Продам а/м "Slamvan"[[курсор]] за $
пслах=Продам а/м "Slamvan"[[курсор]]
псла=Продам а/м "Slamvan"
псолц=Продам а/м "Solair" за $
псолхц=Продам а/м "Solair"[[курсор]] за $
псолх=Продам а/м "Solair"[[курсор]]
псол=Продам а/м "Solair"
пстафц=Продам а/м "Stafford" за $
пстафхц=Продам а/м "Stafford"[[курсор]] за $
пстафх=Продам а/м "Stafford"[[курсор]]
пстаф=Продам а/м "Stafford"
псталц=Продам а/м "Stallion" за $
псталхц=Продам а/м "Stallion"[[курсор]] за $
псталх=Продам а/м "Stallion"[[курсор]]
пстал=Продам а/м "Stallion"
пстрац=Продам а/м "Stratum" за $
пстрахц=Продам а/м "Stratum"[[курсор]] за $
пстрах=Продам а/м "Stratum"[[курсор]]
пстра=Продам а/м "Stratum"
пстрец=Продам а/м "Stretch" за $
пстрехц=Продам а/м "Stretch"[[курсор]] за $
пстрех=Продам а/м "Stretch"[[курсор]]
пстре=Продам а/м "Stretch"
псубаруц=Продам а/м "Subaru Impreza STI" за $
псубарухц=Продам а/м "Subaru Impreza STI"[[курсор]] за $
псубарух=Продам а/м "Subaru Impreza STI"[[курсор]]
псубару=Продам а/м "Subaru Impreza STI"
псулц=Продам а/м "Sultan" за $
псулхц=Продам а/м "Sultan"[[курсор]] за $
псулх=Продам а/м "Sultan"[[курсор]]
псул=Продам а/м "Sultan"
псанц=Продам а/м "Sunrise" за $
псанхц=Продам а/м "Sunrise"[[курсор]] за $
псанх=Продам а/м "Sunrise"[[курсор]]
псан=Продам а/м "Sunrise"
псупц=Продам а/м "Super GT" за $
псупхц=Продам а/м "Super GT"[[курсор]] за $
псупх=Продам а/м "Super GT"[[курсор]]
псуп=Продам а/м "Super GT"
птахц=Продам а/м "Tahoma" за $
птаххц=Продам а/м "Tahoma"[[курсор]] за $
птахх=Продам а/м "Tahoma"[[курсор]]
птах=Продам а/м "Tahoma"
птамц=Продам а/м "Tampa" за $
птамхц=Продам а/м "Tampa"[[курсор]] за $
птамх=Продам а/м "Tampa"[[курсор]]
птам=Продам а/м "Tampa"
пторц=Продам а/м "Tornado" за $
пторхц=Продам а/м "Tornado"[[курсор]] за $
пторх=Продам а/м "Tornado"[[курсор]]
птор=Продам а/м "Tornado"
пкамриц=Продам а/м "Toyota Camry 3.5" за $
пкамрихц=Продам а/м "Toyota Camry 3.5"[[курсор]] за $
пкамрих=Продам а/м "Toyota Camry 3.5"[[курсор]]
пкамри=Продам а/м "Toyota Camry 3.5"
пкоролц=Продам а/м "Toyota Corolla GT-S" за $
пкоролхц=Продам а/м "Toyota Corolla GT-S"[[курсор]] за $
пкоролх=Продам а/м "Toyota Corolla GT-S"[[курсор]]
пкорол=Продам а/м "Toyota Corolla GT-S"
псуп8ц=Продам а/м "Toyota Supra A80" за $
псуп8хц=Продам а/м "Toyota Supra A80"[[курсор]] за $
псуп8х=Продам а/м "Toyota Supra A80"[[курсор]]
псуп8=Продам а/м "Toyota Supra A80"
псуп9ц=Продам а/м "Toyota Supra A90" за $
псуп9хц=Продам а/м "Toyota Supra A90"[[курсор]] за $
псуп9х=Продам а/м "Toyota Supra A90"[[курсор]]
псуп9=Продам а/м "Toyota Supra A90"
птракц=Продам а/м "Tractor" за $
птракхц=Продам а/м "Tractor"[[курсор]] за $
птракх=Продам а/м "Tractor"[[курсор]]
птрак=Продам а/м "Tractor"
птагц=Продам а/м "Tug" за $
птагхц=Продам а/м "Tug"[[курсор]] за $
птагх=Продам а/м "Tug"[[курсор]]
птаг=Продам а/м "Tug"
птурц=Продам а/м "Turismo" за $
птурхц=Продам а/м "Turismo"[[курсор]] за $
птурх=Продам а/м "Turismo"[[курсор]]
птур=Продам а/м "Turismo"
пурац=Продам а/м "Uranus" за $
пурахц=Продам а/м "Uranus"[[курсор]] за $
пурах=Продам а/м "Uranus"[[курсор]]
пура=Продам а/м "Uranus"
пвинцц=Продам а/м "Vincent" за $
пвинцхц=Продам а/м "Vincent"[[курсор]] за $
пвинцх=Продам а/м "Vincent"[[курсор]]
пвинц=Продам а/м "Vincent"
пвирц=Продам а/м "Virgo" за $
пвирхц=Продам а/м "Virgo"[[курсор]] за $
пвирх=Продам а/м "Virgo"[[курсор]]
пвир=Продам а/м "Virgo"
ппасц=Продам а/м "Volkswagen Passat CC" за $
ппасхц=Продам а/м "Volkswagen Passat CC"[[курсор]] за $
ппасх=Продам а/м "Volkswagen Passat CC"[[курсор]]
ппас=Продам а/м "Volkswagen Passat CC"
пвудц=Продам а/м "Voodoo" за $
пвудхц=Продам а/м "Voodoo"[[курсор]] за $
пвудх=Продам а/м "Voodoo"[[курсор]]
пвуд=Продам а/м "Voodoo"
пвашц=Продам а/м "Washington" за $
пвашхц=Продам а/м "Washington"[[курсор]] за $
пвашх=Продам а/м "Washington"[[курсор]]
пваш=Продам а/м "Washington"
пвилц=Продам а/м "Willard" за $
пвилхц=Продам а/м "Willard"[[курсор]] за $
пвилх=Продам а/м "Willard"[[курсор]]
пвил=Продам а/м "Willard"
пвиндц=Продам а/м "Windsor" за $
пвиндхц=Продам а/м "Windsor"[[курсор]] за $
пвиндх=Продам а/м "Windsor"[[курсор]]
пвинд=Продам а/м "Windsor"
пюсехц=Продам а/м "Yosemite"[[курсор]] за $
пюсех=Продам а/м "Yosemite"[[курсор]]
пюсе=Продам а/м "Yosemite"
пзрц=Продам а/м "ZR-350" за $
пзрхц=Продам а/м "ZR-350"[[курсор]] за $
пзрх=Продам а/м "ZR-350"[[курсор]]
пзр=Продам а/м "ZR-350"
педптц=Продам амуницию в размере [курсор] единиц за $
пхптц=Продам амуницию в размере [курсор] единиц за $
педпт=Продам амуницию в размере [курсор] единиц
пхпт=Продам амуницию в размере [курсор] единиц
пптц=Продам амуницию для страйкбола за $
ппт=Продам амуницию для страйкбола
пигрушкиц=Продам антистресс-игрушки за $
пигрушки=Продам антистресс-игрушки
пигрхц=Продам антистресс-игрушку "[курсор]" за $
пигрх=Продам антистресс-игрушку "[курсор]"
ппопитц=Продам антистресс-игрушку "Поп ит" за $
ппопит=Продам антистресс-игрушку "Поп ит"
псимплц=Продам антистресс-игрушку "Симпл димпл" за $
псимпл=Продам антистресс-игрушку "Симпл димпл"
пспинц=Продам антистресс-игрушку "Спиннер" за $
пспин=Продам антистресс-игрушку "Спиннер"
пбхгдец=Продам бизнес "[курсор]"  за $
пбхгде=Продам бизнес "[курсор]" 
пбхц=Продам бизнес "[курсор]" за $
пбх=Продам бизнес "[курсор]"
пмастхц=Продам бизнес "Автомастерская" [курсор] за $
пмастх=Продам бизнес "Автомастерская" 
пмастц=Продам бизнес "Автомастерская" за $
пмаст=Продам бизнес "Автомастерская"
пкомфц=Продам бизнес "Автосалон Комфорт" за $
пкомф=Продам бизнес "Автосалон Комфорт"
пэкоц=Продам бизнес "Автосалон Эконом" за $
пэко=Продам бизнес "Автосалон Эконом"
пэлитц=Продам бизнес "Автосалон Элитный" за $
пэлит=Продам бизнес "Автосалон Элитный"
пазсхц=Продам бизнес "АЗС" [курсор] за $
пазсх=Продам бизнес "АЗС" 
пазсц=Продам бизнес "АЗС" за $
пазс=Продам бизнес "АЗС"
пбархц=Продам бизнес "Бар" [курсор] за $
пбарх=Продам бизнес "Бар" 
пбарц=Продам бизнес "Бар" за $
пбар=Продам бизнес "Бар"
пвелоц=Продам бизнес "Велосалон" за $
пвело=Продам бизнес "Велосалон"
пврсхц=Продам бизнес "Воздушные RC игрушки" [курсор] за $
пврсх=Продам бизнес "Воздушные RC игрушки" 
пврсц=Продам бизнес "Воздушные RC игрушки" за $
пврс=Продам бизнес "Воздушные RC игрушки"
пджетц=Продам бизнес "Джетпак" за $
пджет=Продам бизнес "Джетпак"
пзакхц=Продам бизнес "Закусочная" [курсор] за $
пзакх=Продам бизнес "Закусочная" 
пзакц=Продам бизнес "Закусочная" за $
пзак=Продам бизнес "Закусочная"
пкорц=Продам бизнес "Корабль" за $
пкор=Продам бизнес "Корабль"
п247хц=Продам бизнес "Магазин 24/7" [курсор] за $
пмагхц=Продам бизнес "Магазин 24/7" [курсор] за $
п247х=Продам бизнес "Магазин 24/7" 
пмагх=Продам бизнес "Магазин 24/7" 
п247ц=Продам бизнес "Магазин 24/7" за $
пмагц=Продам бизнес "Магазин 24/7" за $
п247=Продам бизнес "Магазин 24/7"
пмаг=Продам бизнес "Магазин 24/7"
паксхц=Продам бизнес "Магазин аксессуаров" [курсор] за $
паксх=Продам бизнес "Магазин аксессуаров" 
паксц=Продам бизнес "Магазин аксессуаров" за $
пакс=Продам бизнес "Магазин аксессуаров"
подежхц=Продам бизнес "Магазин одежды" [курсор] за $
подежх=Продам бизнес "Магазин одежды" 
подежц=Продам бизнес "Магазин одежды" за $
подеж=Продам бизнес "Магазин одежды"
пхипиц=Продам бизнес "Магазин Hippi" за $
пхиппиц=Продам бизнес "Магазин Hippi" за $
пхипи=Продам бизнес "Магазин Hippi"
пхиппи=Продам бизнес "Магазин Hippi"
пмотоц=Продам бизнес "Мотосалон" за $
пмото=Продам бизнес "Мотосалон"
поружхц=Продам бизнес "Оружейный магазин" [курсор] за $
поружх=Продам бизнес "Оружейный магазин" 
поружц=Продам бизнес "Оружейный магазин" за $
поруж=Продам бизнес "Оружейный магазин"
ппарашютц=Продам бизнес "Парашютные прыжки" за $
ппарашют=Продам бизнес "Парашютные прыжки"
ппарикхц=Продам бизнес "Парикмахерская" [курсор] за $
ппарикх=Продам бизнес "Парикмахерская" 
ппарикц=Продам бизнес "Парикмахерская" за $
ппарик=Продам бизнес "Парикмахерская"
ппенц=Продам бизнес "Пенек" за $
ппен=Продам бизнес "Пенек"
ппироц=Продам бизнес "Пиротехника" за $
псалютц=Продам бизнес "Пиротехника" за $
ппиро=Продам бизнес "Пиротехника"
псалют=Продам бизнес "Пиротехника"
ппочхц=Продам бизнес "Починка транспорта" [курсор] за $
ппочх=Продам бизнес "Починка транспорта" 
ппочц=Продам бизнес "Починка транспорта" за $
ппоч=Продам бизнес "Починка транспорта"
пагентц=Продам бизнес "Риэлторское агенство" за $
пагент=Продам бизнес "Риэлторское агенство"
прыбц=Продам бизнес "Рыболовный магазин" за $
прыб=Продам бизнес "Рыболовный магазин"
псигхц=Продам бизнес "Табачный магазин" [курсор] за $
птабакхц=Продам бизнес "Табачный магазин" [курсор] за $
псигх=Продам бизнес "Табачный магазин" 
птабакх=Продам бизнес "Табачный магазин" 
псигц=Продам бизнес "Табачный магазин" за $
птабакц=Продам бизнес "Табачный магазин" за $
псиг=Продам бизнес "Табачный магазин"
птабак=Продам бизнес "Табачный магазин"
прсхц=Продам бизнес "RC игрушки" [курсор] за $
прсх=Продам бизнес "RC игрушки" 
прсц=Продам бизнес "RC игрушки" за $
прс=Продам бизнес "RC игрушки"
пбгдец=Продам бизнес [курсор] за $
пбгде=Продам бизнес 
пбц=Продам бизнес за $
пб=Продам бизнес
пвмц=Продам в/м "[курсор]" за $
пвм=Продам в/м "[курсор]"
пбайц=Продам в/м "Bike" за $
пвбц=Продам в/м "Bike" за $
пбай=Продам в/м "Bike"
пвб=Продам в/м "Bike"
пбмхц=Продам в/м "BMX" за $
пвбмхц=Продам в/м "BMX" за $
пбмх=Продам в/м "BMX"
пвбмх=Продам в/м "BMX"
пвгц=Продам в/м "Mountain Bike" за $
пвмбц=Продам в/м "Mountain Bike" за $
пгорц=Продам в/м "Mountain Bike" за $
пвг=Продам в/м "Mountain Bike"
пвмб=Продам в/м "Mountain Bike"
пгор=Продам в/м "Mountain Bike"
ппенниц=Продам в/м "Penny farthing" за $
ппенни=Продам в/м "Penny farthing"
ппазлц=Продам головоломку "Пазл" за $
ппазл=Продам головоломку "Пазл"
ппятнц=Продам головоломку "Пятнашки" за $
ппятн=Продам головоломку "Пятнашки"
пбашц=Продам головоломку "Ханойская башня" за $
пбаш=Продам головоломку "Ханойская башня"
ппетухц=Продам декоративную птицу за $
ппетух=Продам декоративную птицу
пдрц=Продам дерево за $
пдр=Продам дерево
пдгде=Продам дом 
пд1орц=Продам дом 1-го класса в "Опасном районе" за $
пд1ор=Продам дом 1-го класса в "Опасном районе"
пд1вмфц=Продам дом 1-го класса в военном городке за $
пд1вмф=Продам дом 1-го класса в военном городке
пд1лвц=Продам дом 1-го класса в г. Лас-Вентурас за $
пд1лв=Продам дом 1-го класса в г. Лас-Вентурас
пд1лсц=Продам дом 1-го класса в г. Лос-Сантос за $
пд1лс=Продам дом 1-го класса в г. Лос-Сантос
пд1сфц=Продам дом 1-го класса в г. Сан-Фиерро за $
пд1сф=Продам дом 1-го класса в г. Сан-Фиерро
пд1прлвц=Продам дом 1-го класса в пригороде Лас-Вентураса за $
пд1прлв=Продам дом 1-го класса в пригороде Лас-Вентураса
пд1прлсц=Продам дом 1-го класса в пригороде Лос-Сантоса за $
пд1прлс=Продам дом 1-го класса в пригороде Лос-Сантоса
пд1прсфц=Продам дом 1-го класса в пригороде Сан-Фиерро за $
пд1прсф=Продам дом 1-го класса в пригороде Сан-Фиерро
пд1ввсц=Продам дом 1-го класса в пустыне за $
пд1свц=Продам дом 1-го класса в пустыне за $
пд1ввс=Продам дом 1-го класса в пустыне
пд1св=Продам дом 1-го класса в пустыне
пд1ппц=Продам дом 1-го класса в районе "Prickle Pine" за $
пд1пп=Продам дом 1-го класса в районе "Prickle Pine"
пд1ц=Продам дом 1-го класса за $
пд1ввц=Продам дом 1-го класса на горе "VineWood" за $
пд1вв=Продам дом 1-го класса на горе "VineWood"
пд1смц=Продам дом 1-го класса на пляже "Санта-Мария" за $
пд1см=Продам дом 1-го класса на пляже "Санта-Мария"
пд1хорц=Продам дом 1-го класса №[курсор] в "Опасном районе" за $
пд1хор=Продам дом 1-го класса №[курсор] в "Опасном районе"
пд1хвмфц=Продам дом 1-го класса №[курсор] в военном городке за $
пд1хвмф=Продам дом 1-го класса №[курсор] в военном городке
пд1хлвц=Продам дом 1-го класса №[курсор] в г. Лас-Вентурас за $
пд1хлв=Продам дом 1-го класса №[курсор] в г. Лас-Вентурас
пд1хлсц=Продам дом 1-го класса №[курсор] в г. Лос-Сантос за $
пд1хлс=Продам дом 1-го класса №[курсор] в г. Лос-Сантос
пд1хсфц=Продам дом 1-го класса №[курсор] в г. Сан-Фиерро за $
пд1хсф=Продам дом 1-го класса №[курсор] в г. Сан-Фиерро
пд1хпрлвц=Продам дом 1-го класса №[курсор] в пригороде Лас-Вентураса за $
пд1хпрлв=Продам дом 1-го класса №[курсор] в пригороде Лас-Вентураса
пд1хпрлсц=Продам дом 1-го класса №[курсор] в пригороде Лос-Сантоса за $
пд1хпрлс=Продам дом 1-го класса №[курсор] в пригороде Лос-Сантоса
пд1хпрсфц=Продам дом 1-го класса №[курсор] в пригороде Сан-Фиерро за $
пд1хпрсф=Продам дом 1-го класса №[курсор] в пригороде Сан-Фиерро
пд1хввсц=Продам дом 1-го класса №[курсор] в пустыне за $
пд1хсвц=Продам дом 1-го класса №[курсор] в пустыне за $
пд1хввс=Продам дом 1-го класса №[курсор] в пустыне
пд1хсв=Продам дом 1-го класса №[курсор] в пустыне
пд1хппц=Продам дом 1-го класса №[курсор] в районе "Prickle Pine" за $
пд1хпп=Продам дом 1-го класса №[курсор] в районе "Prickle Pine"
пд1хц=Продам дом 1-го класса №[курсор] за $
пд1хввц=Продам дом 1-го класса №[курсор] на горе "VineWood" за $
пд1хвв=Продам дом 1-го класса №[курсор] на горе "VineWood"
пд1хсмц=Продам дом 1-го класса №[курсор] на пляже "Санта-Мария" за $
пд1хсм=Продам дом 1-го класса №[курсор] на пляже "Санта-Мария"
пд1х=Продам дом 1-го класса №
пд1=Продам дом 1-го класса
пд2орц=Продам дом 2-го класса в "Опасном районе" за $
пд2ор=Продам дом 2-го класса в "Опасном районе"
пд2вмфц=Продам дом 2-го класса в военном городке за $
пд2вмф=Продам дом 2-го класса в военном городке
пд2лвц=Продам дом 2-го класса в г. Лас-Вентурас за $
пд2лв=Продам дом 2-го класса в г. Лас-Вентурас
пд2лсц=Продам дом 2-го класса в г. Лос-Сантос за $
пд2лс=Продам дом 2-го класса в г. Лос-Сантос
пд2сфц=Продам дом 2-го класса в г. Сан-Фиерро за $
пд2сф=Продам дом 2-го класса в г. Сан-Фиерро
пд2прлвц=Продам дом 2-го класса в пригороде Лас-Вентураса за $
пд2прлв=Продам дом 2-го класса в пригороде Лас-Вентураса
пд2прлсц=Продам дом 2-го класса в пригороде Лос-Сантоса за $
пд2прлс=Продам дом 2-го класса в пригороде Лос-Сантоса
пд2прсфц=Продам дом 2-го класса в пригороде Сан-Фиерро за $
пд2прсф=Продам дом 2-го класса в пригороде Сан-Фиерро
пд2ввсц=Продам дом 2-го класса в пустыне за $
пд2свц=Продам дом 2-го класса в пустыне за $
пд2ввс=Продам дом 2-го класса в пустыне
пд2св=Продам дом 2-го класса в пустыне
пд2пкрц=Продам дом 2-го класса в районе "Palomino Creek" за $
пд2пкр=Продам дом 2-го класса в районе "Palomino Creek"
пд2ппц=Продам дом 2-го класса в районе "Prickle Pine" за $
пд2пп=Продам дом 2-го класса в районе "Prickle Pine"
пд2ц=Продам дом 2-го класса за $
пд2ввц=Продам дом 2-го класса на горе "VineWood" за $
пд2вв=Продам дом 2-го класса на горе "VineWood"
пд2смц=Продам дом 2-го класса на пляже "Санта-Мария" за $
пд2см=Продам дом 2-го класса на пляже "Санта-Мария"
пд2хорц=Продам дом 2-го класса №[курсор] в "Опасном районе" за $
пд2хор=Продам дом 2-го класса №[курсор] в "Опасном районе"
пд2хвмфц=Продам дом 2-го класса №[курсор] в военном городке за $
пд2хвмф=Продам дом 2-го класса №[курсор] в военном городке
пд2хлвц=Продам дом 2-го класса №[курсор] в г. Лас-Вентурас за $
пд2хлв=Продам дом 2-го класса №[курсор] в г. Лас-Вентурас
пд2хлсц=Продам дом 2-го класса №[курсор] в г. Лос-Сантос за $
пд2хлс=Продам дом 2-го класса №[курсор] в г. Лос-Сантос
пд2хсфц=Продам дом 2-го класса №[курсор] в г. Сан-Фиерро за $
пд2хсф=Продам дом 2-го класса №[курсор] в г. Сан-Фиерро
пд2хпрлвц=Продам дом 2-го класса №[курсор] в пригороде Лас-Вентураса за $
пд2хпрлв=Продам дом 2-го класса №[курсор] в пригороде Лас-Вентураса
пд2хпрлсц=Продам дом 2-го класса №[курсор] в пригороде Лос-Сантоса за $
пд2хпрлс=Продам дом 2-го класса №[курсор] в пригороде Лос-Сантоса
пд2хпрсфц=Продам дом 2-го класса №[курсор] в пригороде Сан-Фиерро за $
пд2хпрсф=Продам дом 2-го класса №[курсор] в пригороде Сан-Фиерро
пд2хввсц=Продам дом 2-го класса №[курсор] в пустыне за $
пд2хсвц=Продам дом 2-го класса №[курсор] в пустыне за $
пд2хввс=Продам дом 2-го класса №[курсор] в пустыне
пд2хсв=Продам дом 2-го класса №[курсор] в пустыне
пд2хпкрц=Продам дом 2-го класса №[курсор] в районе "Palomino Creek" за $
пд2хпкр=Продам дом 2-го класса №[курсор] в районе "Palomino Creek"
пд2хппц=Продам дом 2-го класса №[курсор] в районе "Prickle Pine" за $
пд2хпп=Продам дом 2-го класса №[курсор] в районе "Prickle Pine"
пд2хц=Продам дом 2-го класса №[курсор] за $
пд2хввц=Продам дом 2-го класса №[курсор] на горе "VineWood" за $
пд2хвв=Продам дом 2-го класса №[курсор] на горе "VineWood"
пд2хсмц=Продам дом 2-го класса №[курсор] на пляже "Санта-Мария" за $
пд2хсм=Продам дом 2-го класса №[курсор] на пляже "Санта-Мария"
пд2х=Продам дом 2-го класса №
пд2=Продам дом 2-го класса
пд3орц=Продам дом 3-го класса в "Опасном районе" за $
пд3ор=Продам дом 3-го класса в "Опасном районе"
пд3вмфц=Продам дом 3-го класса в военном городке за $
пд3вмф=Продам дом 3-го класса в военном городке
пд3лвц=Продам дом 3-го класса в г. Лас-Вентурас за $
пд3лв=Продам дом 3-го класса в г. Лас-Вентурас
пд3лсц=Продам дом 3-го класса в г. Лос-Сантос за $
пд3лс=Продам дом 3-го класса в г. Лос-Сантос
пд3сфц=Продам дом 3-го класса в г. Сан-Фиерро за $
пд3сф=Продам дом 3-го класса в г. Сан-Фиерро
пд3прлвц=Продам дом 3-го класса в пригороде Лас-Вентураса за $
пд3прлв=Продам дом 3-го класса в пригороде Лас-Вентураса
пд3прлсц=Продам дом 3-го класса в пригороде Лос-Сантоса за $
пд3прлс=Продам дом 3-го класса в пригороде Лос-Сантоса
пд3прсфц=Продам дом 3-го класса в пригороде Сан-Фиерро за $
пд3прсф=Продам дом 3-го класса в пригороде Сан-Фиерро
пд3ввсц=Продам дом 3-го класса в пустыне за $
пд3свц=Продам дом 3-го класса в пустыне за $
пд3ввс=Продам дом 3-го класса в пустыне
пд3св=Продам дом 3-го класса в пустыне
пд3ппц=Продам дом 3-го класса в районе "Prickle Pine" за $
пд3пп=Продам дом 3-го класса в районе "Prickle Pine"
пд3ц=Продам дом 3-го класса за $
пд3ввц=Продам дом 3-го класса на горе "VineWood" за $
пд3вв=Продам дом 3-го класса на горе "VineWood"
пд3смц=Продам дом 3-го класса на пляже "Санта-Мария" за $
пд3см=Продам дом 3-го класса на пляже "Санта-Мария"
пд3хорц=Продам дом 3-го класса №[курсор] в "Опасном районе" за $
пд3хор=Продам дом 3-го класса №[курсор] в "Опасном районе"
пд3хвмфц=Продам дом 3-го класса №[курсор] в военном городке за $
пд3хвмф=Продам дом 3-го класса №[курсор] в военном городке
пд3хлвц=Продам дом 3-го класса №[курсор] в г. Лас-Вентурас за $
пд3хлв=Продам дом 3-го класса №[курсор] в г. Лас-Вентурас
пд3хлсц=Продам дом 3-го класса №[курсор] в г. Лос-Сантос за $
пд3хлс=Продам дом 3-го класса №[курсор] в г. Лос-Сантос
пд3хсфц=Продам дом 3-го класса №[курсор] в г. Сан-Фиерро за $
пд3хсф=Продам дом 3-го класса №[курсор] в г. Сан-Фиерро
пд3хпрлвц=Продам дом 3-го класса №[курсор] в пригороде Лас-Вентураса за $
пд3хпрлв=Продам дом 3-го класса №[курсор] в пригороде Лас-Вентураса
пд3хпрлсц=Продам дом 3-го класса №[курсор] в пригороде Лос-Сантоса за $
пд3хпрлс=Продам дом 3-го класса №[курсор] в пригороде Лос-Сантоса
пд3хпрсфц=Продам дом 3-го класса №[курсор] в пригороде Сан-Фиерро за $
пд3хпрсф=Продам дом 3-го класса №[курсор] в пригороде Сан-Фиерро
пд3хввсц=Продам дом 3-го класса №[курсор] в пустыне за $
пд3хсвц=Продам дом 3-го класса №[курсор] в пустыне за $
пд3хввс=Продам дом 3-го класса №[курсор] в пустыне
пд3хсв=Продам дом 3-го класса №[курсор] в пустыне
пд3хппц=Продам дом 3-го класса №[курсор] в районе "Prickle Pine" за $
пд3хпп=Продам дом 3-го класса №[курсор] в районе "Prickle Pine"
пд3хц=Продам дом 3-го класса №[курсор] за $
пд3хввц=Продам дом 3-го класса №[курсор] на горе "VineWood" за $
пд3хвв=Продам дом 3-го класса №[курсор] на горе "VineWood"
пд3хсмц=Продам дом 3-го класса №[курсор] на пляже "Санта-Мария" за $
пд3хсм=Продам дом 3-го класса №[курсор] на пляже "Санта-Мария"
пд3х=Продам дом 3-го класса №
пд3=Продам дом 3-го класса
пд4орц=Продам дом 4-го класса в "Опасном районе" за $
пд4ор=Продам дом 4-го класса в "Опасном районе"
пд4вмфц=Продам дом 4-го класса в военном городке за $
пд4вмф=Продам дом 4-го класса в военном городке
пд4лвц=Продам дом 4-го класса в г. Лас-Вентурас за $
пд4лв=Продам дом 4-го класса в г. Лас-Вентурас
пд4лсц=Продам дом 4-го класса в г. Лос-Сантос за $
пд4лс=Продам дом 4-го класса в г. Лос-Сантос
пд4сфц=Продам дом 4-го класса в г. Сан-Фиерро за $
пд4сф=Продам дом 4-го класса в г. Сан-Фиерро
пд4прлвц=Продам дом 4-го класса в пригороде Лас-Вентураса за $
пд4прлв=Продам дом 4-го класса в пригороде Лас-Вентураса
пд4прлсц=Продам дом 4-го класса в пригороде Лос-Сантоса за $
пд4прлс=Продам дом 4-го класса в пригороде Лос-Сантоса
пд4прсфц=Продам дом 4-го класса в пригороде Сан-Фиерро за $
пд4прсф=Продам дом 4-го класса в пригороде Сан-Фиерро
пд4ввсц=Продам дом 4-го класса в пустыне за $
пд4свц=Продам дом 4-го класса в пустыне за $
пд4ввс=Продам дом 4-го класса в пустыне
пд4св=Продам дом 4-го класса в пустыне
пд4ппц=Продам дом 4-го класса в районе "Prickle Pine" за $
пд4пп=Продам дом 4-го класса в районе "Prickle Pine"
пд4ц=Продам дом 4-го класса за $
пд4ввц=Продам дом 4-го класса на горе "VineWood" за $
пд4вв=Продам дом 4-го класса на горе "VineWood"
пд4смц=Продам дом 4-го класса на пляже "Санта-Мария" за $
пд4см=Продам дом 4-го класса на пляже "Санта-Мария"
пд4хорц=Продам дом 4-го класса №[курсор] в "Опасном районе" за $
пд4хор=Продам дом 4-го класса №[курсор] в "Опасном районе"
пд4хвмфц=Продам дом 4-го класса №[курсор] в военном городке за $
пд4хвмф=Продам дом 4-го класса №[курсор] в военном городке
пд4хлвц=Продам дом 4-го класса №[курсор] в г. Лас-Вентурас за $
пд4хлв=Продам дом 4-го класса №[курсор] в г. Лас-Вентурас
пд4хлсц=Продам дом 4-го класса №[курсор] в г. Лос-Сантос за $
пд4хлс=Продам дом 4-го класса №[курсор] в г. Лос-Сантос
пд4хсфц=Продам дом 4-го класса №[курсор] в г. Сан-Фиерро за $
пд4хсф=Продам дом 4-го класса №[курсор] в г. Сан-Фиерро
пд4хпрлвц=Продам дом 4-го класса №[курсор] в пригороде Лас-Вентураса за $
пд4хпрлв=Продам дом 4-го класса №[курсор] в пригороде Лас-Вентураса
пд4хпрлсц=Продам дом 4-го класса №[курсор] в пригороде Лос-Сантоса за $
пд4хпрлс=Продам дом 4-го класса №[курсор] в пригороде Лос-Сантоса
пд4хпрсфц=Продам дом 4-го класса №[курсор] в пригороде Сан-Фиерро за $
пд4хпрсф=Продам дом 4-го класса №[курсор] в пригороде Сан-Фиерро
пд4хввсц=Продам дом 4-го класса №[курсор] в пустыне за $
пд4хсвц=Продам дом 4-го класса №[курсор] в пустыне за $
пд4хввс=Продам дом 4-го класса №[курсор] в пустыне
пд4хсв=Продам дом 4-го класса №[курсор] в пустыне
пд4хппц=Продам дом 4-го класса №[курсор] в районе "Prickle Pine" за $
пд4хпп=Продам дом 4-го класса №[курсор] в районе "Prickle Pine"
пд4хц=Продам дом 4-го класса №[курсор] за $
пд4хввц=Продам дом 4-го класса №[курсор] на горе "VineWood" за $
пд4хвв=Продам дом 4-го класса №[курсор] на горе "VineWood"
пд4хсмц=Продам дом 4-го класса №[курсор] на пляже "Санта-Мария" за $
пд4хсм=Продам дом 4-го класса №[курсор] на пляже "Санта-Мария"
пд4х=Продам дом 4-го класса №
пд4=Продам дом 4-го класса
пд5орц=Продам дом 5-го класса в "Опасном районе" за $
пд5ор=Продам дом 5-го класса в "Опасном районе"
пд5вмфц=Продам дом 5-го класса в военном городке за $
пд5вмф=Продам дом 5-го класса в военном городке
пд5лвц=Продам дом 5-го класса в г. Лас-Вентурас за $
пд5лв=Продам дом 5-го класса в г. Лас-Вентурас
пд5лсц=Продам дом 5-го класса в г. Лос-Сантос за $
пд5лс=Продам дом 5-го класса в г. Лос-Сантос
пд5сфц=Продам дом 5-го класса в г. Сан-Фиерро за $
пд5сф=Продам дом 5-го класса в г. Сан-Фиерро
пд5прлвц=Продам дом 5-го класса в пригороде Лас-Вентураса за $
пд5прлв=Продам дом 5-го класса в пригороде Лас-Вентураса
пд5прлсц=Продам дом 5-го класса в пригороде Лос-Сантоса за $
пд5прлс=Продам дом 5-го класса в пригороде Лос-Сантоса
пд5прсфц=Продам дом 5-го класса в пригороде Сан-Фиерро за $
пд5прсф=Продам дом 5-го класса в пригороде Сан-Фиерро
пд5ввсц=Продам дом 5-го класса в пустыне за $
пд5свц=Продам дом 5-го класса в пустыне за $
пд5ввс=Продам дом 5-го класса в пустыне
пд5св=Продам дом 5-го класса в пустыне
пд5ппц=Продам дом 5-го класса в районе "Prickle Pine" за $
пд5пп=Продам дом 5-го класса в районе "Prickle Pine"
пд5ц=Продам дом 5-го класса за $
пд5ввц=Продам дом 5-го класса на горе "VineWood" за $
пд5вв=Продам дом 5-го класса на горе "VineWood"
пд5смц=Продам дом 5-го класса на пляже "Санта-Мария" за $
пд5см=Продам дом 5-го класса на пляже "Санта-Мария"
пд5хорц=Продам дом 5-го класса №[курсор] в "Опасном районе" за $
пд5хор=Продам дом 5-го класса №[курсор] в "Опасном районе"
пд5хвмфц=Продам дом 5-го класса №[курсор] в военном городке за $
пд5хвмф=Продам дом 5-го класса №[курсор] в военном городке
пд5хлвц=Продам дом 5-го класса №[курсор] в г. Лас-Вентурас за $
пд5хлв=Продам дом 5-го класса №[курсор] в г. Лас-Вентурас
пд5хлсц=Продам дом 5-го класса №[курсор] в г. Лос-Сантос за $
пд5хлс=Продам дом 5-го класса №[курсор] в г. Лос-Сантос
пд5хсфц=Продам дом 5-го класса №[курсор] в г. Сан-Фиерро за $
пд5хсф=Продам дом 5-го класса №[курсор] в г. Сан-Фиерро
пд5хпрлвц=Продам дом 5-го класса №[курсор] в пригороде Лас-Вентураса за $
пд5хпрлв=Продам дом 5-го класса №[курсор] в пригороде Лас-Вентураса
пд5хпрлсц=Продам дом 5-го класса №[курсор] в пригороде Лос-Сантоса за $
пд5хпрлс=Продам дом 5-го класса №[курсор] в пригороде Лос-Сантоса
пд5хпрсфц=Продам дом 5-го класса №[курсор] в пригороде Сан-Фиерро за $
пд5хпрсф=Продам дом 5-го класса №[курсор] в пригороде Сан-Фиерро
пд5хввсц=Продам дом 5-го класса №[курсор] в пустыне за $
пд5хсвц=Продам дом 5-го класса №[курсор] в пустыне за $
пд5хввс=Продам дом 5-го класса №[курсор] в пустыне
пд5хсв=Продам дом 5-го класса №[курсор] в пустыне
пд5хппц=Продам дом 5-го класса №[курсор] в районе "Prickle Pine" за $
пд5хпп=Продам дом 5-го класса №[курсор] в районе "Prickle Pine"
пд5хц=Продам дом 5-го класса №[курсор] за $
пд5хввц=Продам дом 5-го класса №[курсор] на горе "VineWood" за $
пд5хвв=Продам дом 5-го класса №[курсор] на горе "VineWood"
пд5хсмц=Продам дом 5-го класса №[курсор] на пляже "Санта-Мария" за $
пд5хсм=Продам дом 5-го класса №[курсор] на пляже "Санта-Мария"
пд5х=Продам дом 5-го класса №
пд5=Продам дом 5-го класса
пд6орц=Продам дом 6-го класса в "Опасном районе" за $
пд6ор=Продам дом 6-го класса в "Опасном районе"
пд6вмфц=Продам дом 6-го класса в военном городке за $
пд6вмф=Продам дом 6-го класса в военном городке
пд6лвц=Продам дом 6-го класса в г. Лас-Вентурас за $
пд6лв=Продам дом 6-го класса в г. Лас-Вентурас
пд6лсц=Продам дом 6-го класса в г. Лос-Сантос за $
пд6лс=Продам дом 6-го класса в г. Лос-Сантос
пд6сфц=Продам дом 6-го класса в г. Сан-Фиерро за $
пд6сф=Продам дом 6-го класса в г. Сан-Фиерро
пд6прлвц=Продам дом 6-го класса в пригороде Лас-Вентураса за $
пд6прлв=Продам дом 6-го класса в пригороде Лас-Вентураса
пд6прлсц=Продам дом 6-го класса в пригороде Лос-Сантоса за $
пд6прлс=Продам дом 6-го класса в пригороде Лос-Сантоса
пд6прсфц=Продам дом 6-го класса в пригороде Сан-Фиерро за $
пд6прсф=Продам дом 6-го класса в пригороде Сан-Фиерро
пд6ввсц=Продам дом 6-го класса в пустыне за $
пд6свц=Продам дом 6-го класса в пустыне за $
пд6ввс=Продам дом 6-го класса в пустыне
пд6св=Продам дом 6-го класса в пустыне
пд6ппц=Продам дом 6-го класса в районе "Prickle Pine" за $
пд6пп=Продам дом 6-го класса в районе "Prickle Pine"
пд6ц=Продам дом 6-го класса за $
пд6ввц=Продам дом 6-го класса на горе "VineWood" за $
пд6вв=Продам дом 6-го класса на горе "VineWood"
пд6смц=Продам дом 6-го класса на пляже "Санта-Мария" за $
пд6см=Продам дом 6-го класса на пляже "Санта-Мария"
пд6хорц=Продам дом 6-го класса №[курсор] в "Опасном районе" за $
пд6хор=Продам дом 6-го класса №[курсор] в "Опасном районе"
пд6хвмфц=Продам дом 6-го класса №[курсор] в военном городке за $
пд6хвмф=Продам дом 6-го класса №[курсор] в военном городке
пд6хлвц=Продам дом 6-го класса №[курсор] в г. Лас-Вентурас за $
пд6хлв=Продам дом 6-го класса №[курсор] в г. Лас-Вентурас
пд6хлсц=Продам дом 6-го класса №[курсор] в г. Лос-Сантос за $
пд6хлс=Продам дом 6-го класса №[курсор] в г. Лос-Сантос
пд6хсфц=Продам дом 6-го класса №[курсор] в г. Сан-Фиерро за $
пд6хсф=Продам дом 6-го класса №[курсор] в г. Сан-Фиерро
пд6хпрлвц=Продам дом 6-го класса №[курсор] в пригороде Лас-Вентураса за $
пд6хпрлв=Продам дом 6-го класса №[курсор] в пригороде Лас-Вентураса
пд6хпрлсц=Продам дом 6-го класса №[курсор] в пригороде Лос-Сантоса за $
пд6хпрлс=Продам дом 6-го класса №[курсор] в пригороде Лос-Сантоса
пд6хпрсфц=Продам дом 6-го класса №[курсор] в пригороде Сан-Фиерро за $
пд6хпрсф=Продам дом 6-го класса №[курсор] в пригороде Сан-Фиерро
пд6хввсц=Продам дом 6-го класса №[курсор] в пустыне за $
пд6хсвц=Продам дом 6-го класса №[курсор] в пустыне за $
пд6хввс=Продам дом 6-го класса №[курсор] в пустыне
пд6хсв=Продам дом 6-го класса №[курсор] в пустыне
пд6хппц=Продам дом 6-го класса №[курсор] в районе "Prickle Pine" за $
пд6хпп=Продам дом 6-го класса №[курсор] в районе "Prickle Pine"
пд6хц=Продам дом 6-го класса №[курсор] за $
пд6хввц=Продам дом 6-го класса №[курсор] на горе "VineWood" за $
пд6хвв=Продам дом 6-го класса №[курсор] на горе "VineWood"
пд6хсмц=Продам дом 6-го класса №[курсор] на пляже "Санта-Мария" за $
пд6хсм=Продам дом 6-го класса №[курсор] на пляже "Санта-Мария"
пд6х=Продам дом 6-го класса №
пд6=Продам дом 6-го класса
пдорц=Продам дом в "Опасном районе" за $
пдор=Продам дом в "Опасном районе"
пдвмфц=Продам дом в военном городке за $
пдвмф=Продам дом в военном городке
пдлвц=Продам дом в г. Лас-Вентурас за $
пдлв=Продам дом в г. Лас-Вентурас
пдлсц=Продам дом в г. Лос-Сантос за $
пдлс=Продам дом в г. Лос-Сантос
пдсфц=Продам дом в г. Сан-Фиерро за $
пдсф=Продам дом в г. Сан-Фиерро
пдпрлвц=Продам дом в пригороде Лас-Вентураса за $
пдпрлв=Продам дом в пригороде Лас-Вентураса
пдпрлсц=Продам дом в пригороде Лос-Сантоса за $
пдпрлс=Продам дом в пригороде Лос-Сантоса
пдпрсфц=Продам дом в пригороде Сан-Фиерро за $
пдпрсф=Продам дом в пригороде Сан-Фиерро
пдввсц=Продам дом в пустыне за $
пдсвц=Продам дом в пустыне за $
пдввс=Продам дом в пустыне
пдсв=Продам дом в пустыне
пдпкрц=Продам дом в районе "Palomino Creek" за $
пдпкр=Продам дом в районе "Palomino Creek"
пдппц=Продам дом в районе "Prickle Pine" за $
пдпп=Продам дом в районе "Prickle Pine"
пдц=Продам дом за $
пдввц=Продам дом на горе "VineWood" за $
пдвв=Продам дом на горе "VineWood"
пдсмц=Продам дом на пляже "Санта-Мария" за $
пдсм=Продам дом на пляже "Санта-Мария"
пдхорц=Продам дом №[курсор] в "Опасном районе" за $
пдхор=Продам дом №[курсор] в "Опасном районе"
пдхвмфц=Продам дом №[курсор] в военном городке за $
пдхвмф=Продам дом №[курсор] в военном городке
пдхлвц=Продам дом №[курсор] в г. Лас-Вентурас за $
пдхлв=Продам дом №[курсор] в г. Лас-Вентурас
пдхлсц=Продам дом №[курсор] в г. Лос-Сантос за $
пдхлс=Продам дом №[курсор] в г. Лос-Сантос
пдхсфц=Продам дом №[курсор] в г. Сан-Фиерро за $
пдхсф=Продам дом №[курсор] в г. Сан-Фиерро
пдхпрлвц=Продам дом №[курсор] в пригороде Лас-Вентураса за $
пдхпрлв=Продам дом №[курсор] в пригороде Лас-Вентураса
пдхпрлсц=Продам дом №[курсор] в пригороде Лос-Сантоса за $
пдхпрлс=Продам дом №[курсор] в пригороде Лос-Сантоса
пдхпрсфц=Продам дом №[курсор] в пригороде Сан-Фиерро за $
пдхпрсф=Продам дом №[курсор] в пригороде Сан-Фиерро
пдхввсц=Продам дом №[курсор] в пустыне за $
пдхсвц=Продам дом №[курсор] в пустыне за $
пдхввс=Продам дом №[курсор] в пустыне
пдхсв=Продам дом №[курсор] в пустыне
пдхпкрц=Продам дом №[курсор] в районе "Palomino Creek" за $
пдхпкр=Продам дом №[курсор] в районе "Palomino Creek"
пдхппц=Продам дом №[курсор] в районе "Prickle Pine" за $
пдхпп=Продам дом №[курсор] в районе "Prickle Pine"
пдхц=Продам дом №[курсор] за $
пдхввц=Продам дом №[курсор] на горе "VineWood" за $
пдхвв=Продам дом №[курсор] на горе "VineWood"
пдхсмц=Продам дом №[курсор] на пляже "Санта-Мария" за $
пдхсм=Продам дом №[курсор] на пляже "Санта-Мария"
пдх=Продам дом №
пд=Продам дом
пжц=Продам железо за $
пж=Продам железо
пхспортц=Продам к/м "Honda Sportrax 250EX" за $
пхспортхц=Продам к/м "Honda Sportrax 250EX"[[курсор]] за $
пхспортх=Продам к/м "Honda Sportrax 250EX"[[курсор]]
пхспорт=Продам к/м "Honda Sportrax 250EX"
пквц=Продам к/м "Quad" за $
пквхц=Продам к/м "Quad"[[курсор]] за $
пквх=Продам к/м "Quad"[[курсор]]
пкв=Продам к/м "Quad"
пммц=Продам м/м "[курсор]" за $
пммх=Продам м/м "[курсор]"[] за $
пммх=Продам м/м "[курсор]"[]
пмм=Продам м/м "[курсор]"
пбфц=Продам м/м "BF-400" за $
пбфхц=Продам м/м "BF-400"[[курсор]] за $
пбфх=Продам м/м "BF-400"[[курсор]]
пбф=Продам м/м "BF-400"
пбмврц=Продам м/м "BMW R 1200RT" за $
пбмврхц=Продам м/м "BMW R 1200RT"[[курсор]] за $
пбмврх=Продам м/м "BMW R 1200RT"[[курсор]]
пбмвр=Продам м/м "BMW R 1200RT"
пчоперц=Продам м/м "Chopper" за $
пчоперхц=Продам м/м "Chopper"[[курсор]] за $
пчоперх=Продам м/м "Chopper"[[курсор]]
пчопер=Продам м/м "Chopper"
пглайдц=Продам м/м "Electra Glide" за $
пглайдхц=Продам м/м "Electra Glide"[[курсор]] за $
пглайдх=Продам м/м "Electra Glide"[[курсор]]
пглайд=Продам м/м "Electra Glide"
пфагц=Продам м/м "Faggio" за $
пфагхц=Продам м/м "Faggio"[[курсор]] за $
пфагх=Продам м/м "Faggio"[[курсор]]
пфаг=Продам м/м "Faggio"
пфцрц=Продам м/м "FCR-900" за $
пфцрхц=Продам м/м "FCR-900"[[курсор]] за $
пфцрх=Продам м/м "FCR-900"[[курсор]]
пфцр=Продам м/м "FCR-900"
пфриц=Продам м/м "Freeway" за $
пфрихц=Продам м/м "Freeway"[[курсор]] за $
пфрих=Продам м/м "Freeway"[[курсор]]
пфри=Продам м/м "Freeway"
пкорнетц=Продам м/м "Honda Cornet C8600F" за $
пкорнетхц=Продам м/м "Honda Cornet C8600F"[[курсор]] за $
пкорнетх=Продам м/м "Honda Cornet C8600F"[[курсор]]
пкорнет=Продам м/м "Honda Cornet C8600F"
пдиоц=Продам м/м "Honda Dio" за $
пдиохц=Продам м/м "Honda Dio"[[курсор]] за $
пдиох=Продам м/м "Honda Dio"[[курсор]]
пдио=Продам м/м "Honda Dio"
пхорнетц=Продам м/м "Honda Hornet C8600F" за $
пхорнетхц=Продам м/м "Honda Hornet C8600F"[[курсор]] за $
пхорнетх=Продам м/м "Honda Hornet C8600F"[[курсор]]
пхорнет=Продам м/м "Honda Hornet C8600F"
пхондахрец=Продам м/м "Honda XRE-300" за $
пхондахрехц=Продам м/м "Honda XRE-300"[[курсор]] за $
пхондахрех=Продам м/м "Honda XRE-300"[[курсор]]
пхондахре=Продам м/м "Honda XRE-300"
пиксрец=Продам м/м "Honda XRE300" за $
пиксрехц=Продам м/м "Honda XRE300"[[курсор]] за $
пиксрех=Продам м/м "Honda XRE300"[[курсор]]
пиксре=Продам м/м "Honda XRE300"
пхпвц=Продам м/м "HPV-1000" за $
пхпвхц=Продам м/м "HPV-1000"[[курсор]] за $
пхпвх=Продам м/м "HPV-1000"[[курсор]]
пхпв=Продам м/м "HPV-1000"
пкаванц=Продам м/м "Kawasaki NRR 1000" за $
пкаванхц=Продам м/м "Kawasaki NRR 1000"[[курсор]] за $
пкаванх=Продам м/м "Kawasaki NRR 1000"[[курсор]]
пкаван=Продам м/м "Kawasaki NRR 1000"
пкавазц=Продам м/м "Kawasaki Z400FX" за $
пкавазхц=Продам м/м "Kawasaki Z400FX"[[курсор]] за $
пкавазх=Продам м/м "Kawasaki Z400FX"[[курсор]]
пкаваз=Продам м/м "Kawasaki Z400FX"
пнргррц=Продам м/м "NRG 500RR" за $
пнргррхц=Продам м/м "NRG 500RR"[[курсор]] за $
пнргррх=Продам м/м "NRG 500RR"[[курсор]]
пнргрр=Продам м/м "NRG 500RR"
пнргц=Продам м/м "NRG-500" за $
пнргхц=Продам м/м "NRG-500"[[курсор]] за $
пнргх=Продам м/м "NRG-500"[[курсор]]
пнрг=Продам м/м "NRG-500"
ппсжц=Продам м/м "PCJ-600" за $
ппсжхц=Продам м/м "PCJ-600"[[курсор]] за $
ппсжх=Продам м/м "PCJ-600"[[курсор]]
ппсж=Продам м/м "PCJ-600"
ппегасиц=Продам м/м "Pegassi FCR 1000" за $
ппегасихц=Продам м/м "Pegassi FCR 1000"[[курсор]] за $
ппегасих=Продам м/м "Pegassi FCR 1000"[[курсор]]
ппегаси=Продам м/м "Pegassi FCR 1000"
ппицц=Продам м/м "Pizzaboy" за $
ппицхц=Продам м/м "Pizzaboy"[[курсор]] за $
ппицх=Продам м/м "Pizzaboy"[[курсор]]
ппиц=Продам м/м "Pizzaboy"
псанчц=Продам м/м "Sanchez" за $
псанчхц=Продам м/м "Sanchez"[[курсор]] за $
псанчх=Продам м/м "Sanchez"[[курсор]]
псанч=Продам м/м "Sanchez"
пвайц=Продам м/м "Wayfarer" за $
пвайхц=Продам м/м "Wayfarer"[[курсор]] за $
пвайх=Продам м/м "Wayfarer"[[курсор]]
пвай=Продам м/м "Wayfarer"
пганц=Продам макет любого оружия за $
пган=Продам макет любого оружия
пганхц=Продам макет оружия "[курсор]" за $
пганх=Продам макет оружия "[курсор]"
пак47ц=Продам макет оружия "AK-47" за $
пакац=Продам макет оружия "AK-47" за $
пак47=Продам макет оружия "AK-47"
пака=Продам макет оружия "AK-47"
пвинтц=Продам макет оружия "Country rifle" за $
прифц=Продам макет оружия "Country rifle" за $
пвинт=Продам макет оружия "Country rifle"
приф=Продам макет оружия "Country rifle"
пдиглц=Продам макет оружия "Desert Eagle" за $
пдигл=Продам макет оружия "Desert Eagle"
пм4ц=Продам макет оружия "M4" за $
пмкац=Продам макет оружия "M4" за $
пм4=Продам макет оружия "M4"
пмка=Продам макет оружия "M4"
пмп5ц=Продам макет оружия "MP5" за $
пмп5=Продам макет оружия "MP5"
побрезц=Продам макет оружия "Sawn-off shotgun" за $
побрез=Продам макет оружия "Sawn-off shotgun"
пдробц=Продам макет оружия "Shotgun" за $
пдроб=Продам макет оружия "Shotgun"
пглушц=Продам макет оружия "Silenced pistol" за $
пглуш=Продам макет оружия "Silenced pistol"
пкемпц=Продам макет оружия "Sniper rifle" за $
пснайпц=Продам макет оружия "Sniper rifle" за $
пкемп=Продам макет оружия "Sniper rifle"
пснайп=Продам макет оружия "Sniper rifle"
пд7орц=Продам особняк 7-го класса в "Опасном районе" за $
пд7ор=Продам особняк 7-го класса в "Опасном районе"
пд7вмфц=Продам особняк 7-го класса в военном городке за $
пд7вмф=Продам особняк 7-го класса в военном городке
пд7лвц=Продам особняк 7-го класса в г. Лас-Вентурас за $
пд7лв=Продам особняк 7-го класса в г. Лас-Вентурас
пд7лсц=Продам особняк 7-го класса в г. Лос-Сантос за $
пд7лс=Продам особняк 7-го класса в г. Лос-Сантос
пд7сфц=Продам особняк 7-го класса в г. Сан-Фиерро за $
пд7сф=Продам особняк 7-го класса в г. Сан-Фиерро
пд7прлвц=Продам особняк 7-го класса в пригороде Лас-Вентураса за $
пд7прлв=Продам особняк 7-го класса в пригороде Лас-Вентураса
пд7прлсц=Продам особняк 7-го класса в пригороде Лос-Сантоса за $
пд7прлс=Продам особняк 7-го класса в пригороде Лос-Сантоса
пд7прсфц=Продам особняк 7-го класса в пригороде Сан-Фиерро за $
пд7прсф=Продам особняк 7-го класса в пригороде Сан-Фиерро
пд7ввсц=Продам особняк 7-го класса в пустыне за $
пд7свц=Продам особняк 7-го класса в пустыне за $
пд7ввс=Продам особняк 7-го класса в пустыне
пд7св=Продам особняк 7-го класса в пустыне
пд7ппц=Продам особняк 7-го класса в районе "Prickle Pine" за $
пд7пп=Продам особняк 7-го класса в районе "Prickle Pine"
пд7ц=Продам особняк 7-го класса за $
пд7ввц=Продам особняк 7-го класса на горе "VineWood" за $
пд7вв=Продам особняк 7-го класса на горе "VineWood"
пд7смц=Продам особняк 7-го класса на пляже "Санта-Мария" за $
пд7см=Продам особняк 7-го класса на пляже "Санта-Мария"
пд7хорц=Продам особняк 7-го класса №[курсор] в "Опасном районе" за $
пд7хор=Продам особняк 7-го класса №[курсор] в "Опасном районе"
пд7хвмфц=Продам особняк 7-го класса №[курсор] в военном городке за $
пд7хвмф=Продам особняк 7-го класса №[курсор] в военном городке
пд7хлвц=Продам особняк 7-го класса №[курсор] в г. Лас-Вентурас за $
пд7хлв=Продам особняк 7-го класса №[курсор] в г. Лас-Вентурас
пд7хлсц=Продам особняк 7-го класса №[курсор] в г. Лос-Сантос за $
пд7хлс=Продам особняк 7-го класса №[курсор] в г. Лос-Сантос
пд7хсфц=Продам особняк 7-го класса №[курсор] в г. Сан-Фиерро за $
пд7хсф=Продам особняк 7-го класса №[курсор] в г. Сан-Фиерро
пд7хпрлвц=Продам особняк 7-го класса №[курсор] в пригороде Лас-Вентураса за $
пд7хпрлв=Продам особняк 7-го класса №[курсор] в пригороде Лас-Вентураса
пд7хпрлсц=Продам особняк 7-го класса №[курсор] в пригороде Лос-Сантоса за $
пд7хпрлс=Продам особняк 7-го класса №[курсор] в пригороде Лос-Сантоса
пд7хпрсфц=Продам особняк 7-го класса №[курсор] в пригороде Сан-Фиерро за $
пд7хпрсф=Продам особняк 7-го класса №[курсор] в пригороде Сан-Фиерро
пд7хввсц=Продам особняк 7-го класса №[курсор] в пустыне за $
пд7хсвц=Продам особняк 7-го класса №[курсор] в пустыне за $
пд7хввс=Продам особняк 7-го класса №[курсор] в пустыне
пд7хсв=Продам особняк 7-го класса №[курсор] в пустыне
пд7хппц=Продам особняк 7-го класса №[курсор] в районе "Prickle Pine" за $
пд7хпп=Продам особняк 7-го класса №[курсор] в районе "Prickle Pine"
пд7хц=Продам особняк 7-го класса №[курсор] за $
пд7хввц=Продам особняк 7-го класса №[курсор] на горе "VineWood" за $
пд7хвв=Продам особняк 7-го класса №[курсор] на горе "VineWood"
пд7хсмц=Продам особняк 7-го класса №[курсор] на пляже "Санта-Мария" за $
пд7хсм=Продам особняк 7-го класса №[курсор] на пляже "Санта-Мария"
пд7х=Продам особняк 7-го класса №
пд7=Продам особняк 7-го класса
препц=Продам положительные отзывы за $
преп=Продам положительные отзывы
ппопц=Продам попугая за $
ппоп=Продам попугая
псемхц=Продам свидетельство о регистрации семьи [курсор]-го поколения за $
псемх=Продам свидетельство о регистрации семьи [курсор]-го поколения
псемц=Продам свидетельство о регистрации семьи за $
псем=Продам свидетельство о регистрации семьи
псц=Продам сим-карту за $
псхц=Продам сим-карту с номером "[курсор]" за $
псх=Продам сим-карту с номером "[курсор]"
пс2ц=Продам сим-карту формата "хх" за $
пс2=Продам сим-карту формата "хх"
пс3ц=Продам сим-карту формата "ххх" за $
пс3=Продам сим-карту формата "ххх"
пс4ц=Продам сим-карту формата "хххх" за $
пс4=Продам сим-карту формата "хххх"
пс5ц=Продам сим-карту формата "ххххх" за $
пс5=Продам сим-карту формата "ххххх"
пс6ц=Продам сим-карту формата "хххххх" за $
пс6=Продам сим-карту формата "хххххх"
пс7ц=Продам сим-карту формата "ххххххх" за $
пс7=Продам сим-карту формата "ххххххх"
пс=Продам сим-карту
пдржц=Продам строительные материалы за $
пждрц=Продам строительные материалы за $
пстрц=Продам строительные материалы за $
пдрж=Продам строительные материалы
пждр=Продам строительные материалы
пстр=Продам строительные материалы
иацтек=Проходит набор в баскетбольную команду "Aztecas"
ибалл=Проходит набор в баскетбольную команду "Ballas"
игрув=Проходит набор в баскетбольную команду "Grove"
ирифа=Проходит набор в баскетбольную команду "Rifa"
ивагос=Проходит набор в баскетбольную команду "Vagos"
мпм=Прямо сейчас состоится мероприятие "[курсор]". Место сбора: 
пвтаксиц=Работает воздушное такси за $
пвтакси=Работает воздушное такси
пминтимц=Работает мужчина по вызову за $
пминтц=Работает мужчина по вызову за $
пминт=Работает мужчина по вызову
пминтим=Работает мужчина по вызову
педац=Работает развозчик еды за $
празвозчикц=Работает развозчик еды за $
педа=Работает развозчик еды
празвозчик=Работает развозчик еды
птаксихц=Работает такси "[курсор]" за $
птаксих=Работает такси "[курсор]"
птаксиц=Работает такси за $
птакц=Работает такси за $
птак=Работает такси
птакси=Работает такси
самц=Сдам в аренду а/м "[курсор]" за $
самхц=Сдам в аренду а/м "[курсор]"[] за $
самх=Сдам в аренду а/м "[курсор]"[]
сам=Сдам в аренду а/м "[курсор]"
схотц=Сдам в аренду а/м "Hotring Racer" за $
схот=Сдам в аренду а/м "Hotring Racer"
синфц=Сдам в аренду а/м "Infernus" за $
синф=Сдам в аренду а/м "Infernus"
смонц=Сдам в аренду а/м "Monster Truck" за $
смон=Сдам в аренду а/м "Monster Truck"
стурц=Сдам в аренду а/м "Turismo" за $
стур=Сдам в аренду а/м "Turismo"
сд1ц=Сдам в аренду дом 1-го класса за $
сд1=Сдам в аренду дом 1-го класса
сд2ц=Сдам в аренду дом 2-го класса за $
сд2=Сдам в аренду дом 2-го класса
сд3ц=Сдам в аренду дом 3-го класса за $
сд3=Сдам в аренду дом 3-го класса
сд4ц=Сдам в аренду дом 4-го класса за $
сд4=Сдам в аренду дом 4-го класса
сд5ц=Сдам в аренду дом 5-го класса за $
сд5=Сдам в аренду дом 5-го класса
сд6ц=Сдам в аренду дом 6-го класса за $
сд6=Сдам в аренду дом 6-го класса
сдц=Сдам в аренду дом за $
сд=Сдам в аренду дом
сммц=Сдам в аренду м/м "[курсор]" за $
сммхц=Сдам в аренду м/м "[курсор]"[] за $
сммх=Сдам в аренду м/м "[курсор]"[]
смм=Сдам в аренду м/м "[курсор]"
сд7ц=Сдам в аренду особняк 7-го класса за $
сд7=Сдам в аренду особняк 7-го класса
патив=Сегодня в [курсор]: состоится вечеринка в доме №[курсор]. Приглашаем всех
патиджиззив=Сегодня в [курсор]ЧЧ:ММ состоится вечеринка в клубе "Jizzy"
патив=Сегодня в ЧЧ:ММ состоится вечеринка в доме №[курсор]. Приглашаем всех
мпсем=Сейчас состоится МП "[курсор]" от семьи "". Место встречи: 
ирод=Семья "[курсор]" ищет дальних родственников
влкн=Трудоустроюсь в итальянский ресторан "La Cosa Nostra" официантом
врм=Трудоустроюсь в ЧОП "Русская стража" охранником для охраны объектов
пличныйводительц=Трудоустроюсь личным водителем за $
пличныйводитель=Трудоустроюсь личным водителем
твод=Трудоустроюсь личным водителем
пличныйохранникц=Трудоустроюсь личным охранником за $
пличныйохранник=Трудоустроюсь личным охранником
ираб=Трудоустроюсь. О себе: 
лвпдк=LVPD Police Car
м4а1=M4
мка=M4
эмка=M4
маджестик=Majestic
манана=Manana
мерс190=Mercedes Benz 190E II
мерсе=Mercedes Benz E-Class
мерсг=Mercedes Benz G-Class
мерссл=Mercedes Benz SL65
мерсамг=Mercedes Benz SLS AMG
мерс124=Mercedes Benz W124
мерср=Mercedes R129
мерит=Merit
меса=Mesa
митсуб=Mitsubishi 3000GT
ланс9=Mitsubishi Lancer Evo IX
ланс10=Mitsubishi Lancer Evo X
монстера=Monster Truck A
монстерб=Monster Truck B
монстер=Monster Truck
горныйвелосипед=Montain Bike
mountain=Montain Bike
Mountain=Montain Bike
мунбим=Moonbeam
мовер=Mower
мп5=MP5
небула=Nebula
нргрр=NRG 500RR
нрг=NRG-500
нрг-500=NRG-500
нрг500=NRG-500
океаник=Oceanic
патр=Patriot
патриот=Patriot
псж=PCJ-600
псж-600=PCJ-600
псж600=PCJ-600
пегаси=Pegassi FCR 1000
перениель=Perennial
феникс=Phoenix
феня=Phoenix
пик=Picador
пицабой=Pizzaboy
пиццабой=Pizzaboy
пл=Plus
рангер=Police Ranger
пони=Pony
порш=Porsche 911 GT2
премьер=Premier
превион=Previon
примо=Primo
ранчер=Rancher
ровер=Range Rover
рс=RC игрушки
регина=Regina
ремингтон=Remington
роллс=Rolls-Royce Phantom 7
ромеро=Romero
рум=Rumpo
сватв=S.W.A.T Van
сабре=Sabre
садлер=Sadler
санчез=Sanchez
санд=Sandking
сандкинг=Sandking
савана=Savanna
обрез=Sawed-off shotgun
сентинель=Sentinel
сфпдк=SFPD Police Car
дробовик=Shotgun
дробь=Shotgun
глушитель=Silenced pistol
пистолетсглушителем=Silenced pistol
тихийпистолет=Silenced pistol
сламван=Slamvan
снайпа=Sniper rifle
снайперка=Sniper rifle
солеир=Solair
соляр=Solair
стафорд=Stafford
сталион=Stallion
стратум=Stratum
лимузин=Stretch
стретч=Stretch
субару=Subaru Impreza STI
султан=Sultan
расвет=Sunrise
санрайз=Sunrise
супергт=Super GT
тахома=Tahoma
тампа=Tampa
торнадо=Tornado
камри=Toyota Camry 3.5
корол=Toyota Corolla GT-S
суп8=Toyota Supra A80
суп9=Toyota Supra A90
трак=Tractor
трактор=Tractor
таг=Tug
туг=Tug
туризмо=Turismo
турик=Turismo
уранус=Uranus
винцент=Vincent
вирго=Virgo
вирджо=Virgo
пас=Volkswagen Passat CC
вуду=Voodoo
вашингтон=Washington
вайфарер=Wayfarer
вайферер=Wayfarer
вейфарер=Wayfarer
вейферер=Wayfarer
вильярд=Willard
виндсор=Windsor
юсе=Yosemite
зр350=ZR-350